Date_new,Date,Description,Credit,Debit,Balance,Calculation Balance,Calculation Credit,Calculated Debit,Checker,Transaction Type,counter
03-10-2017,03-Oct-17,By Opening Balance,0,0,-82581433.46,-82581433.46,0,0,True,Others,39
03-10-2017,03-Oct-17,To RTGS[ID:7766 For120313023790 NOVATCHPROJECTS I PVT LTD],0,1000000,-83581433.46,-83581433.46,0,1000000,True,RTGS,39
03-10-2017,03-Oct-17,To Comm. on RTGS[ID:7766 For120313023790 NOVATCHPROJECTS I PVT LTD],0,60,-83581493.46,-83581493.46,0,60,True,RTGS,39
03-10-2017,03-Oct-17,To ABB RPDE SB/GEN/203MINAL MOHAN JOSHISANDEEP FREIGHT CARRIER,0,85974,-83667467.46,-83667467.46,0,85974,True,Others,39
03-10-2017,03-Oct-17,SANDEEP FREIGHT CARRIER,0,200000,-83867467.46,-83867467.46,0,200000,True,Others,39
03-10-2017,03-Oct-17,TATA CAPITAL FINANCIALSERVICES LTDAIR LINK,0,244816,-84112283.46,-84112283.46,0,244816,True,Others,39
03-10-2017,03-Oct-17,AIR LINK,0,6004,-84118287.46,-84118287.46,0,6004,True,Others,39
03-10-2017,03-Oct-17,To NEFT/UTIB-AKSHAYMEHRA-004417276051800[ID:51800],0,10000,-84128287.46,-84128287.46,0,10000,True,NEFT,39
03-10-2017,03-Oct-17,To Comm.onNEFT:/UTIB-AKSHAYMEHRA-004417276051800[ID:51,0,3,-84128290.46,-84128290.46,0,3,True,NEFT,39
03-10-2017,03-Oct-17,To DORV PROCESSEQUIPMENTS PVT LTDTo NEFT/KKBK-SOUMADEEP,0,75000,-84203290.46,-84203290.46,0,75000,True,NEFT,39
03-10-2017,03-Oct-17,To NEFT/KKBK-SOUMADEEPSUKUM-004417276051818[ID:51818],0,21847,-84225137.46,-84225137.46,0,21847,True,NEFT,39
03-10-2017,03-Oct-17,To Comm.onNEFT:/KKBK-SOUMADEEPSUKUM-004417276051818[ID:51,0,6,-84225143.46,-84225143.46,0,6,True,NEFT,39
04-10-2017,04-Oct-17,By RTGS ID:7769 [From52205850207 BHARAT HEAVYELECTRICALS LTD-TRICHY,2363682,0,-81861461.46,-81861461.46,2363682,0,True,RTGS,39
04-10-2017,04-Oct-17,RANU GAS SERVICE,0,3956,-81865417.46,-81865417.46,0,3956,True,Others,39
04-10-2017,04-Oct-17,MANIBHADRA TUBECORPORATIONParticulars,0,77564,-81942981.46,-81942981.46,0,77564,True,Others,39
04-10-2017,04-Oct-17,KOTAK MAHINDRA BANK LTD,0,146889,-82089870.46,-82089870.46,0,146889,True,Others,39
04-10-2017,04-Oct-17,NAVDA SERVICE STATION,0,10000,-82099870.46,-82099870.46,0,10000,True,Others,39
04-10-2017,04-Oct-17,"To REALISATION OF BILLSBGR-10, 05By Mrg",0,1627462,-83727332.46,-83727332.46,0,1627462,True,Others,39
04-10-2017,04-Oct-17,By MrgRev.GEN(BD)7/1130/HundiNo.BGR/17-18/05,56900,0,-83670432.46,-83670432.46,56900,0,True,Others,39
04-10-2017,04-Oct-17,To Hundi No (BGR/17-18/05),0,7829,-83678261.46,-83678261.46,0,7829,True,Others,39
04-10-2017,04-Oct-17,By MrgRev.GEN(BD)7/1128/HundiNo.BGR/2017-18/010,105846.2,0,-83572415.26,-83572415.26,105846.199999988,0,True,Others,39
04-10-2017,04-Oct-17,To Hundi No (BGR/2017-18/010),0,4045,-83576460.26,-83576460.26,0,4045,True,Others,39
05-10-2017,05-Oct-17,To REAL OF BILL BHEL/17-18/03,0,305271,-83881731.26,-83881731.26,0,305271,True,Others,39
05-10-2017,05-Oct-17,By MrgRev.GEN(BD)7/1129/HundiNo.BHEL /17-18/ 03,30527.1,0,-83851204.16,-83851204.16,30527.1000000089,0,True,Others,39
05-10-2017,05-Oct-17,To Hundi No (BHEL /17-18/ 03),0,817,-83852021.16,-83852021.16,0,817,True,Others,39
05-10-2017,05-Oct-17,To ACH DR IVL FINANC,0,179511,-84031532.16,-84031532.16,0,179511,True,NACH,39
05-10-2017,05-Oct-17,To ACH DR HDFC BANK,0,19408,-84050940.16,-84050940.16,0,19408,True,NACH,39
05-10-2017,05-Oct-17,To ACH DR ADITY BIRL,0,203544,-84254484.16,-84254484.16,0,203544,True,NACH,39
05-10-2017,05-Oct-17,To ACH DR BDACH-RTBN,0,98440,-84352924.16,-84352924.16,0,98440,True,NACH,39
05-10-2017,05-Oct-17,By RTGS ID:7778 From910010050534718SUKUMARKALIPADA,3417000,0,-80935924.16,-80935924.16,3417000,0,True,RTGS,39
05-10-2017,05-Oct-17,NIMBUS LOGISTICS,0,199000,-81134924.16,-81134924.16,0,199000,True,Others,39
05-10-2017,05-Oct-17,MTNL,0,4578,-81139502.16,-81139502.16,0,4578,True,Others,39
05-10-2017,05-Oct-17,SAI SAGAR ENTERPRISES,0,201960,-81341462.16,-81341462.16,0,201960,True,Others,39
05-10-2017,05-Oct-17,By Disc. GEN(BD)7/HundiNo.NPI/AMB/0024/17-18To Disc. GEN(BD)7/Hundi,2778600.6,0,-78562861.56,-78562861.56,2778600.59999999,0,True,Others,39
05-10-2017,05-Oct-17,To Disc. GEN(BD)7/HundiNo.NPI/AMB/0024/17-18OUTREM EUR 28.41,0,63756,-78626617.56,-78626617.56,0,63756,True,Others,39
05-10-2017,05-Oct-17,OUTREM EUR 28.41MISCOW2017004190MISCOW2017004190OUTREM,0,2595,-78629212.56,-78629212.56,0,2595,True,Others,39
06-10-2017,06-Oct-17,To TD/FDL/11214,0,1000000,-79629212.56,-79629212.56,0,1000000,True,Others,39
06-10-2017,06-Oct-17,ASM WELDING PRODUCTS,0,6006,-79635218.56,-79635218.56,0,6006,True,Others,39
06-10-2017,06-Oct-17,To Commission Charged onLC/No.164To Service Charges Charged on,0,21615,-79656833.56,-79656833.56,0,21615,True,CHARGES,39
06-10-2017,06-Oct-17,To Service Charges Charged onLC/No.164To Commission Charged on,0,1150,-79657983.56,-79657983.56,0,1150,True,CHARGES,39
06-10-2017,06-Oct-17,To Commission Charged onLC/No.165Particulars,0,49368,-79707351.56,-79707351.56,0,49368,True,CHARGES,39
06-10-2017,06-Oct-17,To Service Charges Charged onLC/No.165By RTGS ID:7783 From,0,1150,-79708501.56,-79708501.56,0,1150,True,CHARGES,39
06-10-2017,06-Oct-17,By RTGS ID:7783 From00140310000725BERGERAUTOANDINDUSTRIALCOATINGS103,3000000,0,-76708501.56,-76708501.56,3000000,0,True,RTGS,39
06-10-2017,06-Oct-17,To Commission Charged onLC/No.166To Service Charges Charged on,0,108632,-76817133.56,-76817133.56,0,108632,True,CHARGES,39
06-10-2017,06-Oct-17,To Service Charges Charged onLC/No.166To Service Charges Charged on,0,1150,-76818283.56,-76818283.56,0,1150,True,CHARGES,39
06-10-2017,06-Oct-17,To Service Charges Charged onLC/No.167By Transfer TD/FDS/2831,0,1150,-76819433.56,-76819433.56,0,1150,True,CHARGES,39
06-10-2017,06-Oct-17,By Transfer TD/FDS/2831,179768,0,-76639665.56,-76639665.56,179768,0,True,Others,39
06-10-2017,06-Oct-17,By Transfer TD/FDS/2832,162647,0,-76477018.56,-76477018.56,162647,0,True,Others,39
06-10-2017,06-Oct-17,By Transfer TD/FDS/2871,68596,0,-76408422.56,-76408422.56,68596,0,True,Others,39
07-10-2017,07-Oct-17,To DECS HDFC BANK46239223To RTGS[ID:7785 For,0,11900,-76420322.56,-76420322.56,0,11900,True,RTGS,39
07-10-2017,07-Oct-17,To RTGS[ID:7785 For376935313381017 AEBC CARDNO 376935313381017],0,243113,-76663435.56,-76663435.56,0,243113,True,RTGS,39
07-10-2017,07-Oct-17,To Comm. on RTGS[ID:7785 For376935313381017 AEBC CARDNO 376935313381017],0,29,-76663464.56,-76663464.56,0,29,True,RTGS,39
07-10-2017,07-Oct-17,To NEFT/UTIB-HARADHANGHOSH-004417280052189[ID:52189],0,13775,-76677239.56,-76677239.56,0,13775,True,NEFT,39
07-10-2017,07-Oct-17,To Comm.onNEFT:/UTIB-HARADHANGHOSH-004417280052189[ID:52,0,6,-76677245.56,-76677245.56,0,6,True,NEFT,39
07-10-2017,07-Oct-17,To NEFT/UTIB-DIPAKGHOSH-004417280052188[ID:52188],0,75603,-76752848.56,-76752848.56,0,75603,True,NEFT,39
07-10-2017,07-Oct-17,To Comm.on NEFT:/UTIB-DIPAKGHOSH-004417280052188[ID:52188],0,6,-76752854.56,-76752854.56,0,6,True,NEFT,39
07-10-2017,07-Oct-17,To NEFT/BKID-NILESH POPATKA-004417280052186[ID:52186]To Comm.on,0,38755,-76791609.56,-76791609.56,0,38755,True,NEFT,39
07-10-2017,07-Oct-17,To Comm.onNEFT:/BKID-NILESH POPATKA-004417280052186[ID:52186],0,6,-76791615.56,-76791615.56,0,6,True,NEFT,39
07-10-2017,07-Oct-17,To NEFT/CNRB-ANANTAPRASADL-004417280052185[ID:52185],0,19631,-76811246.56,-76811246.56,0,19631,True,NEFT,39
07-10-2017,07-Oct-17,To Comm.onNEFT:/CNRB-ANANTA PRASADL-004417280052185[ID:52185],0,6,-76811252.56,-76811252.56,0,6,True,NEFT,39
07-10-2017,07-Oct-17,To ACH DR MAGMAFINCO,0,121329,-76932581.56,-76932581.56,0,121329,True,NACH,39
07-10-2017,07-Oct-17,USHA FURNITURE MARTParticularsTo NEFT/SBIN-NOVATECH,0,4350,-76936931.56,-76936931.56,0,4350,True,NEFT,39
07-10-2017,07-Oct-17,To NEFT/SBIN-NOVATECHPROJEC-004417280052218[ID:52218],0,1500000,-78436931.56,-78436931.56,0,1500000,True,NEFT,39
07-10-2017,07-Oct-17,To Comm.onNEFT:/SBIN-NOVATECHPROJEC-004417280052218[ID:52,0,29,-78436960.56,-78436960.56,0,29,True,NEFT,39
07-10-2017,07-Oct-17,To NEFT/BKID-SACHINKARAPURK-004417280052223[ID:52223],0,4000,-78440960.56,-78440960.56,0,4000,True,NEFT,39
07-10-2017,07-Oct-17,To Comm.onNEFT:/BKID-SACHINKARAPURK-004417280052223[I,0,3,-78440963.56,-78440963.56,0,3,True,NEFT,39
07-10-2017,07-Oct-17,ToNEFT/BARB-CHHATRASANGBHAI-004417280052220[ID:52220],0,50020,-78490983.56,-78490983.56,0,50020,True,NEFT,39
07-10-2017,7-Oct-17,To Comm.onNEFT:/BARB-CHHATRASANGBHAI-004417280052220[ID:52220],0,6,-78490989.56,-78490989.56,0,6,True,NEFT,39
07-10-2017,7-Oct-17,To NEFT/VIJB-SAI COATS &TRA-004417280052221[ID:52221]To Comm.on NEFT:/VIJB-SAI,0,24835,-78515824.56,-78515824.56,0,24835,True,NEFT,39
07-10-2017,7-Oct-17,To Comm.on NEFT:/VIJB-SAICOATS &TRA-004417280052221[ID:52221],0,6,-78515830.56,-78515830.56,0,6,True,NEFT,39
07-10-2017,7-Oct-17,To NEFT/SBIN-ANJANDAS-004417280052224[ID:52224]To Comm.on NEFT:/SBIN-ANJAN,0,50000,-78565830.56,-78565830.56,0,50000,True,NEFT,39
07-10-2017,7-Oct-17,To Comm.on NEFT:/SBIN-ANJANDAS-004417280052224[ID:52224]By NEFT ID:52240 [From STATE,0,6,-78565836.56,-78565836.56,0,6,True,NEFT,39
09-10-2017,9-Oct-17,By NEFT ID:52240 [From STATEBANK OF INDIA]By RTGS ID:7795 [From IN,50000,0,-78515836.56,-78515836.56,50000,0,True,RTGS,39
09-10-2017,9-Oct-17,By RTGS ID:7795 [From INHSBC 030-445795-001 CRODAINDIA COMPANY PRIVATE,498999,0,-78016837.56,-78016837.56,498999,0,True,RTGS,39
09-10-2017,9-Oct-17,By RTGS ID:7796 [From0129655100002318 BGRENERGY SYSTEMS LTD 443,999941,0,-77016896.56,-77016896.56,999941,0,True,RTGS,39
09-10-2017,9-Oct-17,By RTGS ID:7797 [From140310000725BERGERAUTOANDINDUSTRIAL,352568,0,-76664328.56,-76664328.56,352568,0,True,RTGS,39
09-10-2017,9-Oct-17,MAGMA FINCORP LIMITED,0,161578,-76825906.56,-76825906.56,0,161578,True,Others,39
10-10-2017,10-Oct-17,by o/w-200/2-INTERVALVEPOONAWALA LIMITEDBUDHAJI MAYA PATIL,210000,0,-76615906.56,-76615906.56,210000,0,True,OUTWARD,39
10-10-2017,10-Oct-17,BUDHAJI MAYA PATIL,0,1500,-76617406.56,-76617406.56,0,1500,True,Others,39
10-10-2017,10-Oct-17,L L ELECTRICAL,0,4130,-76621536.56,-76621536.56,0,4130,True,Others,39
10-10-2017,10-Oct-17,VINAYAK INDUSTRIESParticularsOM SHIV JAGRUTI CANTEEN,0,10197,-76631733.56,-76631733.56,0,10197,True,Others,39
10-10-2017,10-Oct-17,OM SHIV JAGRUTI CANTEEN,0,25155,-76656888.56,-76656888.56,0,25155,True,Others,39
10-10-2017,10-Oct-17,INDUSTRIAL SERVICES,0,41920,-76698808.56,-76698808.56,0,41920,True,Others,39
10-10-2017,10-Oct-17,RINKU CARGO MOVERS,0,22000,-76720808.56,-76720808.56,0,22000,True,Others,39
10-10-2017,10-Oct-17,MALLIK ENGINEERING WORKS,0,23630,-76744438.56,-76744438.56,0,23630,True,Others,39
10-10-2017,10-Oct-17,POOJA FABRICATORS,0,45506,-76789944.56,-76789944.56,0,45506,True,Others,39
10-10-2017,10-Oct-17,VIJAY TRADING CO,0,8610,-76798554.56,-76798554.56,0,8610,True,Others,39
10-10-2017,10-Oct-17,OM GASES CHEMICALS,0,28648,-76827202.56,-76827202.56,0,28648,True,Others,39
10-10-2017,10-Oct-17,MALI TUKARAM DNYANU,0,6500,-76833702.56,-76833702.56,0,6500,True,Others,39
10-10-2017,10-Oct-17,By RTGS ID:7806 From00140310000725BERGERAUTOANDINDUSTRIALCOATINGS103,3352568,0,-73481134.56,-73481134.56,3352568,0,True,RTGS,39
11-10-2017,11-Oct-17,To SI TL/B-LOAN/149,0,101876,-73583010.56,-73583010.56,0,101876,True,ECS,39
11-10-2017,11-Oct-17,To Self,0,25000,-73608010.56,-73608010.56,0,25000,True,CASH,39
11-10-2017,11-Oct-17,To NEFT/UTIB-TRIO INFOTECHS-004417284052446[ID:52446]To Comm.on NEFT:/UTIB-TRIO,0,162000,-73770010.56,-73770010.56,0,162000,True,NEFT,39
11-10-2017,11-Oct-17,To Comm.on NEFT:/UTIB-TRIOINFOTECHS-004417284052446[ID:52446],0,16,-73770026.56,-73770026.56,0,16,True,NEFT,39
11-10-2017,11-Oct-17,To RTGS[ID:7811 For00600310013437 ACC LIMITED]To Comm. on RTGS[ID:7811 For,0,308050,-74078076.56,-74078076.56,0,308050,True,RTGS,39
11-10-2017,11-Oct-17,To Comm. on RTGS[ID:7811 For00600310013437 ACC LIMITED]OFFSHORE TESTING AND,0,32,-74078108.56,-74078108.56,0,32,True,RTGS,39
11-10-2017,11-Oct-17,OFFSHORE TESTING ANDINSPECTION SERVICESSEASHELL LOGISTICS PVT LTD,0,43286,-74121394.56,-74121394.56,0,43286,True,Others,39
11-10-2017,11-Oct-17,SEASHELL LOGISTICS PVT LTD,0,247440,-74368834.56,-74368834.56,0,247440,True,Others,39
12-10-2017,12-Oct-17,To NEFT/HDFC-BAJAJ FINANCEL-004417285052560[ID:52560]To Comm.on NEFT:/HDFC-BAJAJ,0,77577,-74446411.56,-74446411.56,0,77577,True,NEFT,39
12-10-2017,12-Oct-17,To Comm.on NEFT:/HDFC-BAJAJFINANCEL-004417285052560[ID:52560],0,6,-74446417.56,-74446417.56,0,6,True,NEFT,39
12-10-2017,12-Oct-17,To RTGS[ID:7813 For2552040000011 AMANPETROLEUM],0,391998,-74838415.56,-74838415.56,0,391998,True,RTGS,39
12-10-2017,12-Oct-17,To Comm. on RTGS[ID:7813 For2552040000011 AMANPETROLEUM],0,32,-74838447.56,-74838447.56,0,32,True,RTGS,39
12-10-2017,12-Oct-17,INDUSTRIAL INNOVATIVEPACKAGINGSAHIL WATER SUPPLIERS,0,8546,-74846993.56,-74846993.56,0,8546,True,Others,39
12-10-2017,12-Oct-17,SAHIL WATER SUPPLIERS,0,24300,-74871293.56,-74871293.56,0,24300,True,Others,39
12-10-2017,12-Oct-17,PRAKASH SHALIK MHATRE,0,14400,-74885693.56,-74885693.56,0,14400,True,Others,39
12-10-2017,12-Oct-17,HOTEL UDYOG VIHAR,0,9707,-74895400.56,-74895400.56,0,9707,True,Others,39
12-10-2017,12-Oct-17,SANTOSH VISHWAKARMA,0,5000,-74900400.56,-74900400.56,0,5000,True,Others,39
12-10-2017,12-Oct-17,NEW AJMER TRAILER SERVICEParticularsTo NEFT/YESB-PASSIM,0,230000,-75130400.56,-75130400.56,0,230000,True,NEFT,39
12-10-2017,12-Oct-17,To NEFT/YESB-PASSIMENGINEER-004417285052592[ID:52592],0,200000,-75330400.56,-75330400.56,0,200000,True,NEFT,39
12-10-2017,12-Oct-17,To Comm.onNEFT:/YESB-PASSIMENGINEER-004417285052592[ID:,0,16,-75330416.56,-75330416.56,0,16,True,NEFT,39
12-10-2017,12-Oct-17,To NEFT/CBIN-SANKARMAITRA-004417285052587[ID:52587],0,10000,-75340416.56,-75340416.56,0,10000,True,NEFT,39
12-10-2017,12-Oct-17,To Comm.onNEFT:/CBIN-SANKARMAITRA-004417285052587[ID:52,0,3,-75340419.56,-75340419.56,0,3,True,NEFT,39
12-10-2017,12-Oct-17,To NEFT/SBIN-ANJANDAS-004417285052586[ID:52586]To Comm.on NEFT:/SBIN-ANJAN,0,50000,-75390419.56,-75390419.56,0,50000,True,NEFT,39
12-10-2017,12-Oct-17,To Comm.on NEFT:/SBIN-ANJANDAS-004417285052586[ID:52586]To OW Return ReqID :7813,0,6,-75390425.56,-75390425.56,0,6,True,OUTWARD,39
12-10-2017,12-Oct-17,To OW Return ReqID :7813,391998,0,-74998427.56,-74998427.56,391998,0,True,OUTWARD,39
13-10-2017,13-Oct-17,To NEFT/HDFC-INDUSTRIALGAS-004417286052624[ID:52624],0,150000,-75148427.56,-75148427.56,0,150000,True,NEFT,39
13-10-2017,13-Oct-17,To Comm.onNEFT:/HDFC-INDUSTRIAL GAS-004417286052624[ID:52624],0,16,-75148443.56,-75148443.56,0,16,True,NEFT,39
13-10-2017,13-Oct-17,To RTGS[ID:7822 For25520400000111 AMANPETROLEUM],0,391998,-75540441.56,-75540441.56,0,391998,True,RTGS,39
13-10-2017,13-Oct-17,To Comm. on RTGS[ID:7822 For25520400000111 AMANPETROLEUM],0,32,-75540473.56,-75540473.56,0,32,True,RTGS,39
13-10-2017,13-Oct-17,TATA AIG GEN INS CO LTD,0,7552,-75548025.56,-75548025.56,0,7552,True,Others,39
13-10-2017,13-Oct-17,SIGNSMITH DISPLAYS PVT LTD,0,15000,-75563025.56,-75563025.56,0,15000,True,Others,39
13-10-2017,13-Oct-17,FAMOUS ELECTRIC WORKS,0,6000,-75569025.56,-75569025.56,0,6000,True,Others,39
13-10-2017,13-Oct-17,MAA HOISTS AND CRANESSERVICESSHUBHAM ELECTRICALS,0,8410,-75577435.56,-75577435.56,0,8410,True,Others,39
13-10-2017,13-Oct-17,SHUBHAM ELECTRICALS,0,2420,-75579855.56,-75579855.56,0,2420,True,Others,39
13-10-2017,13-Oct-17,YES INDUSTRIES,0,500000,-76079855.56,-76079855.56,0,500000,True,Others,39
13-10-2017,13-Oct-17,NASIR ELECTRICALMECHANICAL COGANGARAM DINKAR PATIL,0,21750,-76101605.56,-76101605.56,0,21750,True,Others,39
13-10-2017,13-Oct-17,GANGARAM DINKAR PATIL,0,12736,-76114341.56,-76114341.56,0,12736,True,Others,39
13-10-2017,13-Oct-17,PATIL HARICHANDRA JOMA,0,26235,-76140576.56,-76140576.56,0,26235,True,Others,39
13-10-2017,13-Oct-17,SAI CONSULTANTS,0,8000,-76148576.56,-76148576.56,0,8000,True,Others,39
13-10-2017,13-Oct-17,To NEFT/SBIN-SHAMSHERBAHADU-004417286052678[ID:52678],0,25000,-76173576.56,-76173576.56,0,25000,True,NEFT,39
13-10-2017,13-Oct-17,To Comm.onNEFT:/SBIN-SHAMSHERBAHADU-004417286052678[ID:5,0,6,-76173582.56,-76173582.56,0,6,True,NEFT,39
13-10-2017,13-Oct-17,To NEFT/SBIN-JOHN GALTINTER-004417286052679[ID:52679],0,500000,-76673582.56,-76673582.56,0,500000,True,NEFT,39
13-10-2017,13-Oct-17,To Comm.on NEFT:/SBIN-JOHNGALTINTER-004417286052679[ID:5267,0,29,-76673611.56,-76673611.56,0,29,True,NEFT,39
13-10-2017,13-Oct-17,By NEFT ID:52686 [FromDECCAN FINE CHEMICALSINDIA PRIVATE],1750000,0,-74923611.56,-74923611.56,1750000,0,True,NEFT,39
16-10-2017,16-Oct-17,To DECS TP-ICICI B1380887708To DECS IILECSCN00053180,0,13680,-74937291.56,-74937291.56,0,13680,True,ECS,39
16-10-2017,16-Oct-17,To DECS IILECSCN00053180,0,85227,-75022518.56,-75022518.56,0,85227,True,ECS,39
16-10-2017,16-Oct-17,By RTGS ID:7833 [From140310000725BERGERAUTOANDINDUSTRIAL,1247290,0,-73775228.56,-73775228.56,1247290,0,True,RTGS,39
16-10-2017,16-Oct-17,ROSHNI ENGINEERS,0,23517,-73798745.56,-73798745.56,0,23517,True,Others,39
16-10-2017,16-Oct-17,PURAN ENGINEERING WORKS,0,13098,-73811843.56,-73811843.56,0,13098,True,Others,39
16-10-2017,16-Oct-17,OM SAI CRANE SERVICE,0,135000,-73946843.56,-73946843.56,0,135000,True,Others,39
16-10-2017,16-Oct-17,ROSHNI ENGINEERS,0,11730,-73958573.56,-73958573.56,0,11730,True,Others,39
16-10-2017,16-Oct-17,V R ENGINEERING WORKS,0,7000,-73965573.56,-73965573.56,0,7000,True,Others,39
16-10-2017,16-Oct-17,To Service Charges Charged onLC/No.168VIKAS ENGINEERING CO,0,1150,-73966723.56,-73966723.56,0,1150,True,CHARGES,39
17-10-2017,17-Oct-17,VIKAS ENGINEERING CO,0,10910,-73977633.56,-73977633.56,0,10910,True,Others,39
17-10-2017,17-Oct-17,HARI OM ELECTRIC WORKS,0,28413,-74006046.56,-74006046.56,0,28413,True,Others,39
17-10-2017,17-Oct-17,ELECTRO DIAGNO SYSTEMSPVT LULTRA CHEM SERVICES,0,56326,-74062372.56,-74062372.56,0,56326,True,Others,39
17-10-2017,17-Oct-17,ULTRA CHEM SERVICES,0,47358,-74109730.56,-74109730.56,0,47358,True,Others,39
17-10-2017,17-Oct-17,UNIQUE ENGINEERS,0,212629,-74322359.56,-74322359.56,0,212629,True,Others,39
17-10-2017,17-Oct-17,J S P MACHINERY,0,2950,-74325309.56,-74325309.56,0,2950,True,Others,39
17-10-2017,17-Oct-17,BRITEX ENGINEERING WORKS,0,17588,-74342897.56,-74342897.56,0,17588,True,Others,39
17-10-2017,17-Oct-17,KWALITY AUTO PAINTS,0,167242,-74510139.56,-74510139.56,0,167242,True,Others,39
17-10-2017,17-Oct-17,SHRI VARMA DISH HAND,0,40986,-74551125.56,-74551125.56,0,40986,True,Others,39
17-10-2017,17-Oct-17,OM SAI ELECTRIC WORKS,0,38610,-74589735.56,-74589735.56,0,38610,True,Others,39
17-10-2017,17-Oct-17,TATA AIG GEN INS CO LTD,0,23161,-74612896.56,-74612896.56,0,23161,True,Others,39
17-10-2017,17-Oct-17,SAI SAGAR ENTERPRISES,0,201960,-74814856.56,-74814856.56,0,201960,True,Others,39
17-10-2017,17-Oct-17,To Self,0,125000,-74939856.56,-74939856.56,0,125000,True,CASH,39
17-10-2017,17-Oct-17,To NEFT/IBKL-VARADENGINEERI-004417290052916[ID:52916],0,59300,-74999156.56,-74999156.56,0,59300,True,NEFT,39
17-10-2017,17-Oct-17,To Comm.on NEFT:/IBKL-VARADENGINEERI-004417290052916[ID:52916],0,6,-74999162.56,-74999162.56,0,6,True,NEFT,39
17-10-2017,17-Oct-17,To NEFT/CORP-V SENGINEERING-004417290052923[ID:52923],0,170000,-75169162.56,-75169162.56,0,170000,True,NEFT,39
17-10-2017,17-Oct-17,To Comm.on NEFT:/CORP-V SENGINEERING-004417290052923[ID:52923],0,16,-75169178.56,-75169178.56,0,16,True,NEFT,39
17-10-2017,17-Oct-17,To NEFT/YESB-PASSIMENGINEER-004417290052924[ID:52924],0,400000,-75569178.56,-75569178.56,0,400000,True,NEFT,39
17-10-2017,17-Oct-17,To Comm.onNEFT:/YESB-PASSIMENGINEER-004417290052924[ID:,0,29,-75569207.56,-75569207.56,0,29,True,NEFT,39
17-10-2017,17-Oct-17,To NEFT/BARB-OMCONSULTINGS-004417290052932[ID:52932],0,3053185,-78622392.56,-78622392.56,0,3053185,True,NEFT,39
17-10-2017,17-Oct-17,To Comm.on NEFT:/BARB-OMCONSULTINGS-004417290052932[ID:52932],0,29,-78622421.56,-78622421.56,0,29,True,NEFT,39
17-10-2017,17-Oct-17,To NEFT/IDIB-A P CLEANINGWO-004417290052925[ID:52925]To Comm.on NEFT:/IDIB-A P,0,200000,-78822421.56,-78822421.56,0,200000,True,NEFT,39
17-10-2017,17-Oct-17,To Comm.on NEFT:/IDIB-A PCLEANINGWO-004417290052925[ID:52925],0,16,-78822437.56,-78822437.56,0,16,True,NEFT,39
17-10-2017,17-Oct-17,To NEFT/HDFC-ACCLIMITED-004417290052934[ID:52934],0,308050,-79130487.56,-79130487.56,0,308050,True,NEFT,39
17-10-2017,17-Oct-17,To Comm.on NEFT:/HDFC-ACCLIMITED-004417290052934[ID:52934],0,29,-79130516.56,-79130516.56,0,29,True,NEFT,39
17-10-2017,17-Oct-17,To NEFT/VIJB-SHREE SAINATHC-004417290052935[ID:52935]To Comm.on NEFT:/VIJB-SHREE,0,37584,-79168100.56,-79168100.56,0,37584,True,NEFT,39
17-10-2017,17-Oct-17,To Comm.on NEFT:/VIJB-SHREESAINATHC-004417290052935[ID:52935],0,6,-79168106.56,-79168106.56,0,6,True,NEFT,39
17-10-2017,17-Oct-17,To NEFT/UCBA-AADISHAKTIINDU-004417290052936[ID:52936],0,99000,-79267106.56,-79267106.56,0,99000,True,NEFT,39
17-10-2017,17-Oct-17,To Comm.onNEFT:/UCBA-AADISHAKTIINDU-004417290052936[ID:52936,0,6,-79267112.56,-79267112.56,0,6,True,NEFT,39
18-10-2017,18-Oct-17,By NEFT ID:52945 [FromPASSIM ENGINEERINGWORKS],400000,0,-78867112.56,-78867112.56,400000,0,True,NEFT,39
18-10-2017,18-Oct-17,To LC-No 145 Retired,0,2465033,-81332145.56,-81332145.56,0,2465033,True,Others,39
18-10-2017,18-Oct-17,MSEDCL,0,161270,-81493415.56,-81493415.56,0,161270,True,Others,39
18-10-2017,18-Oct-17,SURESH HARDWARE,0,6528,-81499943.56,-81499943.56,0,6528,True,Others,39
18-10-2017,18-Oct-17,J B ENGINEERINGCORPORATIONParticulars,0,193700,-81693643.56,-81693643.56,0,193700,True,Others,39
18-10-2017,18-Oct-17,KAMAL AGENCIES,0,257488,-81951131.56,-81951131.56,0,257488,True,Others,39
18-10-2017,18-Oct-17,SYNDICATE ENGG INDUSTRIES,0,38367,-81989498.56,-81989498.56,0,38367,True,Others,39
18-10-2017,18-Oct-17,EAGLE BURGMANN INDIA LTD,0,507941,-82497439.56,-82497439.56,0,507941,True,Others,39
18-10-2017,18-Oct-17,VTECH POWER HYDRAULICS,0,6118,-82503557.56,-82503557.56,0,6118,True,Others,39
18-10-2017,18-Oct-17,By RTGS ID:7848 From24605053424M/S NOVATECHPROJECTS (I) PRIVATE,9000000,0,-73503557.56,-73503557.56,9000000,0,True,RTGS,39
18-10-2017,18-Oct-17,By RTGS ID:7849 From24605053424M/S NOVATECHPROJECTS (I) PRIVATE,4100000,0,-69403557.56,-69403557.56,4100000,0,True,RTGS,39
18-10-2017,18-Oct-17,To NEFT/YESB-PASSIMENGINEER-004417291053018[ID:53018],0,400000,-69803557.56,-69803557.56,0,400000,True,NEFT,39
18-10-2017,18-Oct-17,To Comm.onNEFT:/YESB-PASSIMENGINEER-004417291053018[ID:,0,29,-69803586.56,-69803586.56,0,29,True,NEFT,39
18-10-2017,18-Oct-17,"To REALISATION OF BILLSBGR-01, BHEL 01,02,04By Mrg",0,3826548,-73630134.56,-73630134.56,0,3826548,True,Others,39
18-10-2017,18-Oct-17,By MrgRev.GEN(BD)7/1109/HundiNo.BGR -021,125044.2,0,-73505090.36,-73505090.36,125044.200000003,0,True,Others,39
18-10-2017,18-Oct-17,To Hundi No (BGR -021),0,9558,-73514648.36,-73514648.36,0,9558,True,Others,39
18-10-2017,18-Oct-17,By MrgRev.GEN(BD)7/1122/HundiNo.BHEL 01,87547.3,0,-73427101.06,-73427101.06,87547.299999997,0,True,Others,39
18-10-2017,18-Oct-17,To Hundi No (BHEL 01),0,6692,-73433793.06,-73433793.06,0,6692,True,Others,39
18-10-2017,18-Oct-17,By MrgRev.GEN(BD)7/1123/HundiNo.BHEL 002,53931.1,0,-73379861.96,-73379861.96,53931.1000000089,0,True,Others,39
18-10-2017,18-Oct-17,To Hundi No (BHEL 002),0,4122,-73383983.96,-73383983.96,0,4122,True,Others,39
18-10-2017,18-Oct-17,By MrgRev.GEN(BD)7/1124/HundiNo.BHEL 004,116132.2,0,-73267851.76,-73267851.76,116132.199999988,0,True,Others,39
18-10-2017,18-Oct-17,To Hundi No (BHEL 004),0,8877,-73276728.76,-73276728.76,0,8877,True,Others,39
18-10-2017,18-Oct-17,ToNEFT/SBIN-TECHNOCELL-004417291053021[ID:53021],0,150000,-73426728.76,-73426728.76,0,150000,True,NEFT,39
18-10-2017,18-Oct-17,To Comm.onNEFT:/SBIN-TECHNOCELL-004417291053021[ID:53021],0,16,-73426744.76,-73426744.76,0,16,True,NEFT,39
18-10-2017,18-Oct-17,To NEFT/DNSB-PRINCEFABRICAT-004417291053020[ID:53020],0,99000,-73525744.76,-73525744.76,0,99000,True,NEFT,39
18-10-2017,18-Oct-17,To Comm.onNEFT:/DNSB-PRINCEFABRICAT-004417291053020[ID:,0,6,-73525750.76,-73525750.76,0,6,True,NEFT,39
18-10-2017,18-Oct-17,To NEFT/SBIN-NOVATECHPROJEC-004417291053029[ID:53029],0,100000,-73625750.76,-73625750.76,0,100000,True,NEFT,39
18-10-2017,18-Oct-17,To Comm.onNEFT:/SBIN-NOVATECHPROJEC-004417291053029[ID:53,0,6,-73625756.76,-73625756.76,0,6,True,NEFT,39
18-10-2017,18-Oct-17,To NEFT/IBKL-NOVATECHPROJEC-004417291053030[ID:53030],0,150000,-73775756.76,-73775756.76,0,150000,True,NEFT,39
18-10-2017,18-Oct-17,To Comm.onNEFT:/IBKL-NOVATECHPROJEC-004417291053030[ID:53,0,16,-73775772.76,-73775772.76,0,16,True,NEFT,39
19-10-2017,19-Oct-17,MASTER LIFTERS,0,5175,-73780947.76,-73780947.76,0,5175,True,Others,39
19-10-2017,19-Oct-17,A S ENGINEERS ANDFABRICATORSNEW MUBARAK BATTERY,0,200000,-73980947.76,-73980947.76,0,200000,True,Others,39
19-10-2017,19-Oct-17,NEW MUBARAK BATTERYSALES AND SERVICEROADLINES INDIA PVT LTD,0,5900,-73986847.76,-73986847.76,0,5900,True,Others,39
19-10-2017,19-Oct-17,ROADLINES INDIA PVT LTD,0,61750,-74048597.76,-74048597.76,0,61750,True,Others,39
19-10-2017,19-Oct-17,TIME SQUARE LOGISTICS,0,92550,-74141147.76,-74141147.76,0,92550,True,Others,39
19-10-2017,19-Oct-17,MTANDT RENTALS LIMITED,0,300000,-74441147.76,-74441147.76,0,300000,True,Others,39
19-10-2017,19-Oct-17,STARWELD INDUSTRIES,0,14350,-74455497.76,-74455497.76,0,14350,True,Others,39
19-10-2017,19-Oct-17,By NEFT/HDFC-GARDENREACH SH-N292170392474496[ID:53063],8066285.47,0,-66389212.29,-66389212.29,8066285.47000001,0,True,NEFT,39
21-10-2017,21-Oct-17,By RTGS ID:7852 [From120313023790 NOVATECHPROJECTS (INDIA) PVT LTD 601,1700000,0,-64689212.29,-64689212.29,1700000,0,True,RTGS,39
21-10-2017,21-Oct-17,By RTGS ID:7853 From9011125900BHARAT HEAVYELECTRICALS LIMITED,2945518,0,-61743694.29,-61743694.29,2945518,0,True,RTGS,39
21-10-2017,21-Oct-17,By RTGS ID:7851 From120313023790NOVATECHPROJECTS (INDIA) PVT LTD601,4300000,0,-57443694.29,-57443694.29,4300000,0,True,RTGS,39
23-10-2017,23-Oct-17,To VEHICLE LOAN PROC CHGS,0,8260,-57451954.29,-57451954.29,0,8260,True,CHARGES,39
23-10-2017,23-Oct-17,KWALITY AUTO PAINTS,0,300000,-57751954.29,-57751954.29,0,300000,True,Others,39
23-10-2017,23-Oct-17,NOORI INDUSTRIAL GASES,0,100000,-57851954.29,-57851954.29,0,100000,True,Others,39
23-10-2017,23-Oct-17,SHREE GANESH DISHENDWORKSSHUBH STATIONERY,0,2898,-57854852.29,-57854852.29,0,2898,True,Others,39
23-10-2017,23-Oct-17,SHUBH STATIONERYParticularsTo NEFT/SBIN-SHAMSHER,0,19956,-57874808.29,-57874808.29,0,19956,True,NEFT,39
23-10-2017,23-Oct-17,To NEFT/SBIN-SHAMSHERBAHADU-004417296053175[ID:53175],0,40000,-57914808.29,-57914808.29,0,40000,True,NEFT,39
23-10-2017,23-Oct-17,To Comm.onNEFT:/SBIN-SHAMSHERBAHADU-004417296053175[ID:5,0,6,-57914814.29,-57914814.29,0,6,True,NEFT,39
23-10-2017,23-Oct-17,To VEHICLE LOAN DOCSFRANKING CHGSTo REAL OF BILLS EIL,0,1748,-57916562.29,-57916562.29,0,1748,True,CHARGES,39
23-10-2017,23-Oct-17,"To REAL OF BILLS EIL007,03,02, BER/01,02,03By Mrg",0,5673163,-63589725.29,-63589725.29,0,5673163,True,Others,39
23-10-2017,23-Oct-17,By MrgRev.GEN(BD)7/1131/HundiNo.BER/TAL/001,154366.7,0,-63435358.59,-63435358.59,154366.699999996,0,True,Others,39
23-10-2017,23-Oct-17,To Hundi No (BER/TAL/001),0,5900,-63441258.59,-63441258.59,0,5900,True,Others,39
23-10-2017,23-Oct-17,By MrgRev.GEN(BD)7/1137/HundiNo.BER/TAL/003,83322.6,0,-63357935.99,-63357935.99,83322.6000000015,0,True,Others,39
23-10-2017,23-Oct-17,To Hundi No (BER/TAL/003),0,2229,-63360164.99,-63360164.99,0,2229,True,Others,39
23-10-2017,23-Oct-17,By MrgRev.GEN(BD)7/1138/HundiNo.BER/TAL/002,154366.7,0,-63205798.29,-63205798.29,154366.700000003,0,True,Others,39
23-10-2017,23-Oct-17,To Hundi No (BER/TAL/002),0,4130,-63209928.29,-63209928.29,0,4130,True,Others,39
23-10-2017,23-Oct-17,By MrgRev.GEN(BD)7/1153/HundiNo.EIL/007,68139.9,0,-63141788.39,-63141788.39,68139.8999999985,0,True,Others,39
23-10-2017,23-Oct-17,To Hundi No (EIL/007),0,521,-63142309.39,-63142309.39,0,521,True,Others,39
23-10-2017,23-Oct-17,By MrgRev.GEN(BD)7/1151/HundiNo.EIL/003,107120.4,0,-63035188.99,-63035188.99,107120.399999999,0,True,Others,39
23-10-2017,23-Oct-17,To Hundi No (EIL/003),0,7779,-63042967.99,-63042967.99,0,7779,True,Others,39
23-10-2017,23-Oct-17,To REL BILL NO EIL/002,0,681399,-63724366.99,-63724366.99,0,681399,True,Others,39
23-10-2017,23-Oct-17,By MrgRev.GEN(BD)7/1152/HundiNo.EIL/002,68139.9,0,-63656227.09,-63656227.09,68139.8999999985,0,True,Others,39
23-10-2017,23-Oct-17,To Hundi No (EIL/002),0,4948,-63661175.09,-63661175.09,0,4948,True,Others,39
24-10-2017,24-Oct-17,To NEFT/PUNB-MAHA GOVTSTATU-004417297053221[ID:53221],0,630000,-64291175.09,-64291175.09,0,630000,True,NEFT,39
24-10-2017,24-Oct-17,To Comm.on NEFT:/PUNB-MAHAGOVTSTATU-004417297053221[ID:5322,0,29,-64291204.09,-64291204.09,0,29,True,NEFT,39
24-10-2017,24-Oct-17,To Self,0,35000,-64326204.09,-64326204.09,0,35000,True,CASH,39
24-10-2017,24-Oct-17,To NEFT/HDFC-ASHRAYENTERPRI-004417297053234[ID:53234],0,200000,-64526204.09,-64526204.09,0,200000,True,NEFT,39
24-10-2017,24-Oct-17,To Comm.onNEFT:/HDFC-ASHRAYENTERPRI-004417297053234[ID:,0,16,-64526220.09,-64526220.09,0,16,True,NEFT,39
25-10-2017,25-Oct-17,By Disc. GEN(BD)7/HundiNo.BEERGER/025To Disc. GEN(BD)7/Hundi,2787816.6,0,-61738403.49,-61738403.49,2787816.6,0,True,Others,39
25-10-2017,25-Oct-17,To Disc. GEN(BD)7/HundiNo.BEERGER/025By Disc. GEN(BD)7/Hundi,0,51556,-61789959.49,-61789959.49,0,51556,True,Others,39
25-10-2017,25-Oct-17,By Disc. GEN(BD)7/HundiNo.BERGER 015To Disc. GEN(BD)7/Hundi,3669810.3,0,-58120149.19,-58120149.19,3669810.3,0,True,Others,39
25-10-2017,25-Oct-17,To Disc. GEN(BD)7/HundiNo.BERGER 015VINOD SHIVKARAN YADAV,0,56555,-58176704.19,-58176704.19,0,56555,True,Others,39
25-10-2017,25-Oct-17,VINOD SHIVKARAN YADAV,0,12740,-58189444.19,-58189444.19,0,12740,True,Others,39
25-10-2017,25-Oct-17,SOHM ANALYTICAL SERVICESP LTDSAINI ENGINEERING WORKS,0,112099,-58301543.19,-58301543.19,0,112099,True,Others,39
25-10-2017,25-Oct-17,SAINI ENGINEERING WORKS,0,108000,-58409543.19,-58409543.19,0,108000,True,Others,39
25-10-2017,25-Oct-17,RADIAGO WORK SOLUTIONSPVT LTDKWALITY AUTO PAINTS,0,20661,-58430204.19,-58430204.19,0,20661,True,Others,39
25-10-2017,25-Oct-17,KWALITY AUTO PAINTS,0,202602,-58632806.19,-58632806.19,0,202602,True,Others,39
25-10-2017,25-Oct-17,To ADV-26 FRANKING DOCSCHGS FOR VEHICLE LOANBy Disc. GEN(BD)7/Hundi,0,112,-58632918.19,-58632918.19,0,112,True,CHARGES,39
25-10-2017,25-Oct-17,By Disc. GEN(BD)7/HundiNo.BERGER 031To Disc. GEN(BD)7/Hundi,1448002.8,0,-57184915.39,-57184915.39,1448002.8,0,True,Others,39
25-10-2017,25-Oct-17,To Disc. GEN(BD)7/HundiNo.BERGER 031To PO No. Issued.,0,41159,-57226074.39,-57226074.39,0,41159,True,Others,39
26-10-2017,26-Oct-17,To PO No. Issued.,0,50313,-57276387.39,-57276387.39,0,50313,True,Others,39
26-10-2017,26-Oct-17,To PO No. Issued.,0,38497,-57314884.39,-57314884.39,0,38497,True,Others,39
26-10-2017,26-Oct-17,To PO No. Issued.,0,46088,-57360972.39,-57360972.39,0,46088,True,Others,39
26-10-2017,26-Oct-17,To PO No. Issued.,0,29320,-57390292.39,-57390292.39,0,29320,True,Others,39
26-10-2017,26-Oct-17,To PO No. Issued.,0,38747,-57429039.39,-57429039.39,0,38747,True,Others,39
26-10-2017,26-Oct-17,BHAWANA SERVICES,0,7700,-57436739.39,-57436739.39,0,7700,True,Others,39
26-10-2017,26-Oct-17,By RTGS ID:7873 From36530729001RAMAGUNDAMFERTILIZERS AND.,3795300,0,-53641439.39,-53641439.39,3795300,0,True,RTGS,39
26-10-2017,26-Oct-17,To Mrgn Amt TLB-LOAN180,0,37436,-53678875.39,-53678875.39,0,37436,True,ECS,39
26-10-2017,26-Oct-17,To LEGAL CHARGES FORMORTGAGE FORMALITIESTo RTGS[ID:7877 For,0,4132,-53683007.39,-53683007.39,0,4132,True,CHARGES,39
27-10-2017,27-Oct-17,To RTGS[ID:7877 For32343227367 NOVATECHPROJECTS I PV LTD],0,400000,-54083007.39,-54083007.39,0,400000,True,RTGS,39
27-10-2017,27-Oct-17,To Comm. on RTGS[ID:7877 For32343227367 NOVATECHPROJECTS I PV LTD],0,32,-54083039.39,-54083039.39,0,32,True,RTGS,39
27-10-2017,27-Oct-17,To DORV PROCESSEQUIPMENTS PVT LTDMTNL,0,50000,-54133039.39,-54133039.39,0,50000,True,Others,39
27-10-2017,27-Oct-17,MTNL,0,5015,-54138054.39,-54138054.39,0,5015,True,Others,39
27-10-2017,27-Oct-17,To NEFT/UTIB-AMOLLAD-004417300053387[ID:53387]To Comm.on NEFT:/UTIB-AMOL,0,22138,-54160192.39,-54160192.39,0,22138,True,NEFT,39
27-10-2017,27-Oct-17,To Comm.on NEFT:/UTIB-AMOLLAD-004417300053387[ID:53387]Particulars,0,6,-54160198.39,-54160198.39,0,6,True,NEFT,39
27-10-2017,27-Oct-17,To NEFT/UTIB-VAIBHAVSHELKE-004417300053389[ID:53389],0,6000,-54166198.39,-54166198.39,0,6000,True,NEFT,39
27-10-2017,27-Oct-17,To Comm.onNEFT:/UTIB-VAIBHAVSHELKE-004417300053389[ID:53,0,3,-54166201.39,-54166201.39,0,3,True,NEFT,39
27-10-2017,27-Oct-17,To NEFT/UTIB-DIPAKGHOSH-004417300053388[ID:53388],0,16667,-54182868.39,-54182868.39,0,16667,True,NEFT,39
27-10-2017,27-Oct-17,To Comm.on NEFT:/UTIB-DIPAKGHOSH-004417300053388[ID:53388],0,6,-54182874.39,-54182874.39,0,6,True,NEFT,39
27-10-2017,27-Oct-17,To Commission Charged onLC/No.170To Service Charges Charged on,0,40896,-54223770.39,-54223770.39,0,40896,True,CHARGES,39
27-10-2017,27-Oct-17,To Service Charges Charged onLC/No.170To NEFT/IBKL-THE SVC CO,0,1150,-54224920.39,-54224920.39,0,1150,True,CHARGES,39
27-10-2017,27-Oct-17,To NEFT/IBKL-THE SVC COOPER-004417300053429[ID:53429],0,76074,-54300994.39,-54300994.39,0,76074,True,NEFT,39
27-10-2017,27-Oct-17,To Comm.on NEFT:/IBKL-THESVC COOPER-004417300053429[ID:5342,0,6,-54301000.39,-54301000.39,0,6,True,NEFT,39
27-10-2017,27-Oct-17,To NEFT/IBKL-THE SVC COOPER-004417300053426[ID:53426],0,31531,-54332531.39,-54332531.39,0,31531,True,NEFT,39
27-10-2017,27-Oct-17,To Comm.on NEFT:/IBKL-THESVC COOPER-004417300053426[ID:5342,0,6,-54332537.39,-54332537.39,0,6,True,NEFT,39
27-10-2017,27-Oct-17,To NEFT/IBKL-THE SVC COOPER-004417300053423[ID:53423],0,21600,-54354137.39,-54354137.39,0,21600,True,NEFT,39
27-10-2017,27-Oct-17,To Comm.on NEFT:/IBKL-THESVC COOPER-004417300053423[ID:5342,0,6,-54354143.39,-54354143.39,0,6,True,NEFT,39
27-10-2017,27-Oct-17,To NEFT/IBKL-THE SVC COOPER-004417300053431[ID:53431],0,1132866,-55487009.39,-55487009.39,0,1132866,True,NEFT,39
27-10-2017,27-Oct-17,To Comm.on NEFT:/IBKL-THESVC COOPER-004417300053431[ID:5343,0,29,-55487038.39,-55487038.39,0,29,True,NEFT,39
27-10-2017,27-Oct-17,To NEFT/IBKL-THE SVC COOPER-004417300053430[ID:53430],0,268,-55487306.39,-55487306.39,0,268,True,NEFT,39
27-10-2017,27-Oct-17,To Comm.on NEFT:/IBKL-THESVC COOPER-004417300053430[ID:5343,0,3,-55487309.39,-55487309.39,0,3,True,NEFT,39
30-10-2017,30-Oct-17,To RTGS[ID:7889 For120313023790 NOVATECHPROJECTS I PVT LTD],0,2000000,-57487309.39,-57487309.39,0,2000000,True,RTGS,39
30-10-2017,30-Oct-17,To Comm. on RTGS[ID:7889 For120313023790 NOVATECHPROJECTS I PVT LTD],0,64,-57487373.39,-57487373.39,0,64,True,RTGS,39
30-10-2017,30-Oct-17,DEORAO B BATKI,0,38940,-57526313.39,-57526313.39,0,38940,True,Others,39
30-10-2017,30-Oct-17,UNITED SECURITY FORCE,0,115113,-57641426.39,-57641426.39,0,115113,True,Others,39
30-10-2017,30-Oct-17,SANDEEP FREIGHT CARRIER,0,120000,-57761426.39,-57761426.39,0,120000,True,Others,39
30-10-2017,30-Oct-17,To NEFT/VIJB-SAI COATS &TRA-004417303053526[ID:53526]To Comm.on NEFT:/VIJB-SAI,0,289000,-58050426.39,-58050426.39,0,289000,True,NEFT,39
30-10-2017,30-Oct-17,To Comm.on NEFT:/VIJB-SAICOATS &TRA-004417303053526[ID:53526],0,29,-58050455.39,-58050455.39,0,29,True,NEFT,39
31-10-2017,31-Oct-17,To NEFT/IBKL-THE SVC COOPER-004417304053576[ID:53576],0,12525,-58062980.39,-58062980.39,0,12525,True,NEFT,39
31-10-2017,31-Oct-17,To Comm.on NEFT:/IBKL-THESVC COOPER-004417304053576[ID:5357,0,6,-58062986.39,-58062986.39,0,6,True,NEFT,39
31-10-2017,31-Oct-17,To NEFT/IBKL-THE SHAMRAOVIT-004417304053585[ID:53585]To Comm.on NEFT:/IBKL-THE,0,156513,-58219499.39,-58219499.39,0,156513,True,NEFT,39
31-10-2017,31-Oct-17,To Comm.on NEFT:/IBKL-THESHAMRAOVIT-004417304053585[ID:53585],0,16,-58219515.39,-58219515.39,0,16,True,NEFT,39
31-10-2017,31-Oct-17,To NEFT/IBKL-THE SVC COOPER-004417304053586[ID:53586],0,28161,-58247676.39,-58247676.39,0,28161,True,NEFT,39
31-10-2017,31-Oct-17,To Comm.on NEFT:/IBKL-THESVC COOPER-004417304053586[ID:5358,0,6,-58247682.39,-58247682.39,0,6,True,NEFT,39
31-10-2017,31-Oct-17,To NEFT/IBKL-THE SHAMRAOVIT-004417304053587[ID:53587]To Comm.on NEFT:/IBKL-THE,0,193515,-58441197.39,-58441197.39,0,193515,True,NEFT,39
31-10-2017,31-Oct-17,To Comm.on NEFT:/IBKL-THESHAMRAOVIT-004417304053587[ID:53587],0,16,-58441213.39,-58441213.39,0,16,True,NEFT,39
31-10-2017,31-Oct-17,To NEFT/IBKL-THE SHAMRAOVIT-004417304053591[ID:53591]To Comm.on NEFT:/IBKL-THE,0,235353,-58676566.39,-58676566.39,0,235353,True,NEFT,39
31-10-2017,31-Oct-17,To Comm.on NEFT:/IBKL-THESHAMRAOVIT-004417304053591[ID:53591],0,29,-58676595.39,-58676595.39,0,29,True,NEFT,39
31-10-2017,31-Oct-17,To NEFT/IBKL-THE SVC COOPER-004417304053584[ID:53584],0,3270,-58679865.39,-58679865.39,0,3270,True,NEFT,39
31-10-2017,31-Oct-17,To Comm.on NEFT:/IBKL-THESVC COOPER-004417304053584[ID:5358,0,3,-58679868.39,-58679868.39,0,3,True,NEFT,39
31-10-2017,31-Oct-17,SAI INSPECTION SERVICES,0,100000,-58779868.39,-58779868.39,0,100000,True,Others,39
31-10-2017,31-Oct-17,MTNL,0,620,-58780488.39,-58780488.39,0,620,True,Others,39
31-10-2017,31-Oct-17,TANMAY ENTERPRISES,0,36750,-58817238.39,-58817238.39,0,36750,True,Others,39
31-10-2017,31-Oct-17,CHANDANA RIBBONS31-Oct-2017 GOLDY PROJECTS PVT LTD,0,8083,-58825321.39,-58825321.39,0,8083,True,Others,39
31-10-2017,31-Oct-17,31-Oct-2017 GOLDY PROJECTS PVT LTD,0,300000,-59125321.39,-59125321.39,0,300000,True,Others,39
31-10-2017,31-Oct-17,31-Oct-2017 MAHENDRA PRESSINGWORKS31-Oct-2017 MTNL,0,78400,-59203721.39,-59203721.39,0,78400,True,Others,39
31-10-2017,31-Oct-17,31-Oct-2017 MTNL,0,1281,-59205002.39,-59205002.39,0,1281,True,Others,39
31-10-2017,31-Oct-17,31-Oct-2017 To NEFT/IBKL-THE SVC COOPER-004417304053582[ID:53582],0,388472,-59593474.39,-59593474.39,0,388472,True,NEFT,39
31-10-2017,31-Oct-17,31-Oct-2017 To Comm.on NEFT:/IBKL-THESVC COOPER-004417304053582[ID:5358,0,29,-59593503.39,-59593503.39,0,29,True,NEFT,39
31-10-2017,31-Oct-17,31-Oct-2017 To NEFT/IBKL-THE SVC COOPER-004417304053578[ID:53578],0,6517,-59600020.39,-59600020.39,0,6517,True,NEFT,39
31-10-2017,31-Oct-17,31-Oct-2017 To Comm.on NEFT:/IBKL-THESVC COOPER-004417304053578[ID:5357,0,3,-59600023.39,-59600023.39,0,3,True,NEFT,39
31-10-2017,31-Oct-17,31-Oct-2017 To NEFT/IBKL-THE SHAMRAOVIT-004417304053583[ID:53583]31-Oct-2017 To Comm.on NEFT:/IBKL-THE,0,51147,-59651170.39,-59651170.39,0,51147,True,NEFT,39
31-10-2017,31-Oct-17,31-Oct-2017 To Comm.on NEFT:/IBKL-THESHAMRAOVIT-004417304053583[ID:53583],0,6,-59651176.39,-59651176.39,0,6,True,NEFT,39
31-10-2017,31-Oct-17,31-Oct-2017 To NEFT/IBKL-THE SHAMRAOVIT-004417304053577[ID:53577]31-Oct-2017 To Comm.on NEFT:/IBKL-THE,0,24104,-59675280.39,-59675280.39,0,24104,True,NEFT,39
31-10-2017,31-Oct-17,31-Oct-2017 To Comm.on NEFT:/IBKL-THESHAMRAOVIT-004417304053577[ID:53577],0,6,-59675286.39,-59675286.39,0,6,True,NEFT,39
31-10-2017,31-Oct-17,31-Oct-2017 To NEFT/BARB-OMCONSULTINGS-004417304053610[ID:53610],0,536566,-60211852.39,-60211852.39,0,536566,True,NEFT,39
31-10-2017,31-Oct-17,31-Oct-2017 To Comm.on NEFT:/BARB-OMCONSULTINGS-004417304053610[ID:53610],0,29,-60211881.39,-60211881.39,0,29,True,NEFT,39
31-10-2017,31-Oct-17,31-Oct-2017 By NEFT ID:53627 [FromRAMAGUNDAM FERTILIZERS]31-Oct-2017 To Int. Dr. 01/10/2017,1758750,0,-58453131.39,-58453131.39,1758750,0,True,NEFT,39
31-10-2017,31-Oct-17,31-Oct-2017 To Int. Dr. 01/10/2017-0.0015369360436291501-Nov-2017 To LC-No 153 Retired,0,864705,-59317836.39,-59317836.39,0,864705,True,Others,39
01-11-2017,1-Nov-17,01-Nov-2017 To LC-No 153 Retired,0,1542845,-60860681.39,-60860681.39,0,1542845,True,Others,39
01-11-2017,1-Nov-17,01-Nov-2017 To RTGS[ID:7901 For00600310013437 ACC LIMITED]01-Nov-2017 To Comm. on RTGS[ID:7901 For,0,315550,-61176231.39,-61176231.39,0,315550,True,RTGS,39
01-11-2017,1-Nov-17,01-Nov-2017 To Comm. on RTGS[ID:7901 For00600310013437 ACC LIMITED]01-Nov-2017 To INT @ 9.5% FOR 90DAYS,0,32,-61176263.39,-61176263.39,0,32,True,RTGS,39
01-11-2017,1-Nov-17,01-Nov-2017 To INT @ 9.5% FOR 90DAYSUSANCE ON LC NO 15301-Nov-2017 PROFITMAX ADVISORS,0,36141,-61212404.39,-61212404.39,0,36141,True,Others,39
01-11-2017,1-Nov-17,01-Nov-2017 PROFITMAX ADVISORS,0,36214,-61248618.39,-61248618.39,0,36214,True,Others,39
01-11-2017,1-Nov-17,01-Nov-2017 MAHENDRA DISHED ENDS PVT,0,88200,-61336818.39,-61336818.39,0,88200,True,Others,39
01-11-2017,1-Nov-17,01-Nov-2017 MIDC`,0,3370,-61340188.39,-61340188.39,0,3370,True,Others,39
01-11-2017,1-Nov-17,01-Nov-2017 NNEP TECHNOLOGY,0,57885,-61398073.39,-61398073.39,0,57885,True,Others,39
01-11-2017,1-Nov-17,01-Nov-2017 MSEDCLDate Particulars01-Nov-2017 SHOBHA FABRICATORS PVT,0,39370,-61437443.39,-61437443.39,0,39370,True,Others,39
01-11-2017,1-Nov-17,01-Nov-2017 SHOBHA FABRICATORS PVTLTD01-Nov-2017 VIJ INDUSTRIES,0,56884,-61494327.39,-61494327.39,0,56884,True,Others,39
01-11-2017,1-Nov-17,01-Nov-2017 VIJ INDUSTRIES,0,64855,-61559182.39,-61559182.39,0,64855,True,Others,39
01-11-2017,1-Nov-17,01-Nov-2017 By Disc. GEN(BD)7/HundiNo.NPI/AMB/0035/17-1801-Nov-2017 To Disc. GEN(BD)7/Hundi,1389300.3,0,-60169882.09,-60169882.09,1389300.3,0,True,Others,39
01-11-2017,1-Nov-17,01-Nov-2017 To Disc. GEN(BD)7/HundiNo.NPI/AMB/0035/17-1802-Nov-2017 To RTGS[ID:7913 For,0,41394,-60211276.09,-60211276.09,0,41394,True,RTGS,39
02-11-2017,2-Nov-17,02-Nov-2017 To RTGS[ID:7913 For24605053424 NOVATECHPROJECTS I PVT LTD],0,2000000,-62211276.09,-62211276.09,0,2000000,True,RTGS,39
02-11-2017,2-Nov-17,02-Nov-2017 To Comm. on RTGS[ID:7913 For24605053424 NOVATECHPROJECTS I PVT LTD],0,60,-62211336.09,-62211336.09,0,60,True,RTGS,39
02-11-2017,2-Nov-17,02-Nov-2017 To RTGS[ID:7912 For120313023790 NOVATECHPROJECTS I PVT LTD],0,800000,-63011336.09,-63011336.09,0,800000,True,RTGS,39
02-11-2017,2-Nov-17,02-Nov-2017 To Comm. on RTGS[ID:7912 For120313023790 NOVATECHPROJECTS I PVT LTD],0,60,-63011396.09,-63011396.09,0,60,True,RTGS,39
02-11-2017,2-Nov-17,02-Nov-2017 By RTGS ID:7914 [From140310000725BERGERAUTOANDINDUSTRIAL,2484339,0,-60527057.09,-60527057.09,2484339,0,True,RTGS,39
02-11-2017,2-Nov-17,02-Nov-2017 SISTECH CONSULTANTS,0,80325,-60607382.09,-60607382.09,0,80325,True,Others,39
02-11-2017,2-Nov-17,02-Nov-2017 KOTAK MAHINDRA BANK,0,146889,-60754271.09,-60754271.09,0,146889,True,Others,39
02-11-2017,2-Nov-17,02-Nov-2017 CROSSPOINTCOMMUNICATIONS02-Nov-2017 To RTGS[ID:7920 For,0,44365,-60798636.09,-60798636.09,0,44365,True,RTGS,39
02-11-2017,2-Nov-17,02-Nov-2017 To RTGS[ID:7920 For00600310013437 ACC LIMITED]02-Nov-2017 To Comm. on RTGS[ID:7920 For,0,315550,-61114186.09,-61114186.09,0,315550,True,RTGS,39
02-11-2017,2-Nov-17,02-Nov-2017 To Comm. on RTGS[ID:7920 For00600310013437 ACC LIMITED]02-Nov-2017 To NEFT/KKBK-SOUMADEEP,0,35,-61114221.09,-61114221.09,0,35,True,RTGS,39
02-11-2017,2-Nov-17,02-Nov-2017 To NEFT/KKBK-SOUMADEEPSUKUM-004417306053779[ID:53779],0,13467,-61127688.09,-61127688.09,0,13467,True,NEFT,39
02-11-2017,2-Nov-17,02-Nov-2017 To Comm.onNEFT:/KKBK-SOUMADEEPSUKUM-004417306053779[ID:53,0,6,-61127694.09,-61127694.09,0,6,True,NEFT,39
02-11-2017,2-Nov-17,02-Nov-2017 To NEFT/IBKL-THE SVCCO-OPER-004417306053773[ID:53773],0,135230,-61262924.09,-61262924.09,0,135230,True,NEFT,39
02-11-2017,2-Nov-17,02-Nov-2017 To Comm.on NEFT:/IBKL-THESVCCO-OPER-004417306053773[ID:5,0,16,-61262940.09,-61262940.09,0,16,True,NEFT,39
03-11-2017,3-Nov-17,03-Nov-2017 To PROC CHGS ON ADHOCLIMIT OF 2 CR03-Nov-2017 To Self,0,23600,-61286540.09,-61286540.09,0,23600,True,CHARGES,39
03-11-2017,3-Nov-17,03-Nov-2017 To Self,0,50000,-61336540.09,-61336540.09,0,50000,True,CASH,39
03-11-2017,3-Nov-17,03-Nov-2017 To NEFT/UTIB-VAIBHAVSHELKE-004417307053816[ID:53816],0,29400,-61365940.09,-61365940.09,0,29400,True,NEFT,39
03-11-2017,3-Nov-17,03-Nov-2017 To Comm.onNEFT:/UTIB-VAIBHAVSHELKE-004417307053816[ID:53,0,6,-61365946.09,-61365946.09,0,6,True,NEFT,39
03-11-2017,3-Nov-17,03-Nov-2017 To NEFT/SCBL-AEBC CARD NO37-004417307053817[ID:53817]03-Nov-2017 To Comm.on NEFT:/SCBL-AEBC,0,183515,-61549461.09,-61549461.09,0,183515,True,NEFT,39
03-11-2017,3-Nov-17,03-Nov-2017 To Comm.on NEFT:/SCBL-AEBCCARD NO37-004417307053817[ID:53817],0,16,-61549477.09,-61549477.09,0,16,True,NEFT,39
03-11-2017,3-Nov-17,03-Nov-2017 TATA CAPITAL FIN SERVICESLTD03-Nov-2017 SHREE NAVLAI TOURS,0,244816,-61794293.09,-61794293.09,0,244816,True,CASH,39
03-11-2017,3-Nov-17,03-Nov-2017 SHREE NAVLAI TOURSTRAVELS03-Nov-2017 LLOYD S REGISTER ASIA,0,11531,-61805824.09,-61805824.09,0,11531,True,Others,39
03-11-2017,3-Nov-17,03-Nov-2017 LLOYD S REGISTER ASIA,0,420000,-62225824.09,-62225824.09,0,420000,True,Others,39
04-11-2017,4-Nov-17,04-Nov-2017 SUPREME HVAC,0,61127,-62286951.09,-62286951.09,0,61127,True,Others,39
04-11-2017,4-Nov-17,04-Nov-2017 ASHISH ENTERPRISES,0,7434,-62294385.09,-62294385.09,0,7434,True,Others,39
04-11-2017,4-Nov-17,04-Nov-2017 OMKAR CANTEEN,0,200000,-62494385.09,-62494385.09,0,200000,True,Others,39
04-11-2017,4-Nov-17,04-Nov-2017 CLOUD INFRA SOLUTIONS,0,14337,-62508722.09,-62508722.09,0,14337,True,Others,39
04-11-2017,4-Nov-17,04-Nov-2017 N IT SOLUTIONS,0,34810,-62543532.09,-62543532.09,0,34810,True,Others,39
06-11-2017,6-Nov-17,06-Nov-2017 To ACH DR IVL FINANC,0,179511,-62723043.09,-62723043.09,0,179511,True,NACH,39
06-11-2017,6-Nov-17,06-Nov-2017 To ACH DR BDACH-RTBN,0,98440,-62821483.09,-62821483.09,0,98440,True,NACH,39
06-11-2017,6-Nov-17,06-Nov-2017 To ACH DR ADITY BIRL,0,203544,-63025027.09,-63025027.09,0,203544,True,NACH,39
06-11-2017,6-Nov-17,06-Nov-2017 To RTGS[ID:7923 For047102000003926 JASMINOPOLYMERTECH PRIVATE,0,600000,-63625027.09,-63625027.09,0,600000,True,RTGS,39
06-11-2017,6-Nov-17,06-Nov-2017 To Comm. on RTGS[ID:7923 For047102000003926 JASMINOPOLYMERTECH PRIVATE,0,60,-63625087.09,-63625087.09,0,60,True,RTGS,39
06-11-2017,6-Nov-17,06-Nov-2017 SURESH HARDWARE,0,3264,-63628351.09,-63628351.09,0,3264,True,Others,39
06-11-2017,6-Nov-17,06-Nov-2017 To NEFT/SCBL-NOVATECHPROJEC-004417310053995[ID:53995],0,10000000,-73628351.09,-73628351.09,0,10000000,True,NEFT,39
06-11-2017,6-Nov-17,06-Nov-2017 To Comm.onNEFT:/SCBL-NOVATECHPROJEC-004417310053995[ID:53,0,29,-73628380.09,-73628380.09,0,29,True,NEFT,39
06-11-2017,6-Nov-17,06-Nov-2017 To Commission Charged onLC/No.17106-Nov-2017 To Service Charges Charged on,0,27156,-73655536.09,-73655536.09,0,27156,True,CHARGES,39
06-11-2017,6-Nov-17,06-Nov-2017 To Service Charges Charged onLC/No.17106-Nov-2017 To Commission Charged on,0,1150,-73656686.09,-73656686.09,0,1150,True,CHARGES,39
06-11-2017,6-Nov-17,06-Nov-2017 To Commission Charged onLC/No.17206-Nov-2017 To Service Charges Charged on,0,41810,-73698496.09,-73698496.09,0,41810,True,CHARGES,39
06-11-2017,6-Nov-17,06-Nov-2017 To Service Charges Charged onLC/No.17206-Nov-2017 To NEFT/IBKL-THE SVC CO,0,1150,-73699646.09,-73699646.09,0,1150,True,CHARGES,39
06-11-2017,6-Nov-17,06-Nov-2017 To NEFT/IBKL-THE SVC COOPER-004417310054002[ID:54002],0,12930,-73712576.09,-73712576.09,0,12930,True,NEFT,39
06-11-2017,6-Nov-17,06-Nov-2017 To Comm.on NEFT:/IBKL-THESVC COOPER-004417310054002[ID:5400,0,6,-73712582.09,-73712582.09,0,6,True,NEFT,39
06-11-2017,6-Nov-17,06-Nov-2017 To NEFT/SBIN-NOVATECHPROJEC-004417310053999[ID:53999],0,3700000,-77412582.09,-77412582.09,0,3700000,True,NEFT,39
06-11-2017,6-Nov-17,06-Nov-2017 To Comm.onNEFT:/SBIN-NOVATECHPROJEC-004417310053999[ID:53,0,29,-77412611.09,-77412611.09,0,29,True,NEFT,39
07-11-2017,7-Nov-17,07-Nov-2017 To Chq.Bk Chgs : 26101-26200,0,120,-77412731.09,-77412731.09,0,120,True,CHARGES,39
07-11-2017,7-Nov-17,07-Nov-2017 To ACH DR MAGMAFINCO,0,121329,-77534060.09,-77534060.09,0,121329,True,NACH,39
07-11-2017,7-Nov-17,07-Nov-2017 SHREE SHYAM ROADTRANSPORT07-Nov-2017 ELCA LABORATORIES,0,121000,-77655060.09,-77655060.09,0,121000,True,Others,39
07-11-2017,7-Nov-17,07-Nov-2017 ELCA LABORATORIES,0,14174,-77669234.09,-77669234.09,0,14174,True,Others,39
07-11-2017,7-Nov-17,07-Nov-2017 MARVEL TUBES INDUSTRIES,0,172999,-77842233.09,-77842233.09,0,172999,True,Others,39
07-11-2017,7-Nov-17,07-Nov-2017 To NEFT/UTIB-TRIO INFOTECHS-004417311054071[ID:54071]07-Nov-2017 To Comm.on NEFT:/UTIB-TRIO,0,162000,-78004233.09,-78004233.09,0,162000,True,NEFT,39
07-11-2017,7-Nov-17,07-Nov-2017 To Comm.on NEFT:/UTIB-TRIOINFOTECHS-004417311054071[ID:54071],0,16,-78004249.09,-78004249.09,0,16,True,NEFT,39
07-11-2017,7-Nov-17,07-Nov-2017 To NEFT/RATN-NOVATECHPROJEC-004417311054072[ID:54072],0,180071,-78184320.09,-78184320.09,0,180071,True,NEFT,39
07-11-2017,7-Nov-17,07-Nov-2017 To Comm.onNEFT:/RATN-NOVATECHPROJEC-004417311054072[ID:54,0,16,-78184336.09,-78184336.09,0,16,True,NEFT,39
07-11-2017,7-Nov-17,07-Nov-2017 To NEFT/ICIC-CRESCENDOWORLD-004417311054098[ID:54098],0,108000,-78292336.09,-78292336.09,0,108000,True,NEFT,39
07-11-2017,7-Nov-17,07-Nov-2017 To Comm.onNEFT:/ICIC-CRESCENDOWORLD-004417311054098[ID:54,0,16,-78292352.09,-78292352.09,0,16,True,NEFT,39
07-11-2017,7-Nov-17,07-Nov-2017 To NEFT/UTIB-AKSHAYMEHRA-004417311054099[ID:54099],0,10000,-78302352.09,-78302352.09,0,10000,True,NEFT,39
07-11-2017,7-Nov-17,07-Nov-2017 To Comm.onNEFT:/UTIB-AKSHAYMEHRA-004417311054099[ID:540,0,3,-78302355.09,-78302355.09,0,3,True,NEFT,39
08-11-2017,8-Nov-17,08-Nov-2017 To ACH DR HDFC BANK,0,19408,-78321763.09,-78321763.09,0,19408,True,NACH,39
08-11-2017,8-Nov-17,08-Nov-2017 MAGM FINCORP LTD,0,161578,-78483341.09,-78483341.09,0,161578,True,Others,39
08-11-2017,8-Nov-17,08-Nov-2017 QUEST SOLUTIONS,0,51066,-78534407.09,-78534407.09,0,51066,True,Others,39
08-11-2017,8-Nov-17,08-Nov-2017 To STAMP DOCS FOR VEHICLELOAN09-Nov-2017 To DECS HDFC BANK,0,112,-78534519.09,-78534519.09,0,112,True,ECS,39
09-11-2017,9-Nov-17,09-Nov-2017 To DECS HDFC BANK46239223Date Particulars,0,11900,-78546419.09,-78546419.09,0,11900,True,ECS,39
09-11-2017,9-Nov-17,09-Nov-2017 To NEFT/UTIB-AMOLLAD-004417313054214[ID:54214]09-Nov-2017 To Comm.on NEFT:/UTIB-AMOL,0,10000,-78556419.09,-78556419.09,0,10000,True,NEFT,39
09-11-2017,9-Nov-17,09-Nov-2017 To Comm.on NEFT:/UTIB-AMOLLAD-004417313054214[ID:54214]09-Nov-2017 To NEFT/CNRB-ANANTA,0,3,-78556422.09,-78556422.09,0,3,True,NEFT,39
09-11-2017,9-Nov-17,09-Nov-2017 To NEFT/CNRB-ANANTAPRASADL-004417313054215[ID:54215],0,47282,-78603704.09,-78603704.09,0,47282,True,NEFT,39
09-11-2017,9-Nov-17,09-Nov-2017 To Comm.onNEFT:/CNRB-ANANTA PRASADL-004417313054215[ID:54215],0,6,-78603710.09,-78603710.09,0,6,True,NEFT,39
09-11-2017,9-Nov-17,09-Nov-2017 OM LIFTERS,0,70537,-78674247.09,-78674247.09,0,70537,True,Others,39
09-11-2017,9-Nov-17,09-Nov-2017 SRI BALAJI LOGISTICS,0,222785,-78897032.09,-78897032.09,0,222785,True,Others,39
09-11-2017,9-Nov-17,09-Nov-2017 SHREE KRISHNA DISHEND,0,36432,-78933464.09,-78933464.09,0,36432,True,Others,39
09-11-2017,9-Nov-17,09-Nov-2017 N K ENGINEERS,0,64363,-78997827.09,-78997827.09,0,64363,True,Others,39
09-11-2017,9-Nov-17,09-Nov-2017 INLAND WORLD LOGISTICS PLTD09-Nov-2017 S S ENGINEERING COMPANY,0,98000,-79095827.09,-79095827.09,0,98000,True,Others,39
09-11-2017,9-Nov-17,09-Nov-2017 S S ENGINEERING COMPANY,0,46891,-79142718.09,-79142718.09,0,46891,True,Others,39
09-11-2017,9-Nov-17,09-Nov-2017 V K TRANSPORT SERVICE,0,200000,-79342718.09,-79342718.09,0,200000,True,Others,39
09-11-2017,9-Nov-17,09-Nov-2017 JAI AMBE DISHING WORKS,0,24465,-79367183.09,-79367183.09,0,24465,True,Others,39
09-11-2017,9-Nov-17,09-Nov-2017 B M COATS,0,100000,-79467183.09,-79467183.09,0,100000,True,Others,39
09-11-2017,9-Nov-17,09-Nov-2017 MAHENDRA KASURDE,0,4500,-79471683.09,-79471683.09,0,4500,True,Others,39
09-11-2017,9-Nov-17,09-Nov-2017 BRILLIANT INDUSTRIES,0,20189,-79491872.09,-79491872.09,0,20189,True,Others,39
10-11-2017,10-Nov-17,10-Nov-2017 To NEFT/IBKL-THE SVCCO-OPER-004417314054297[ID:54297],0,129788,-79621660.09,-79621660.09,0,129788,True,NEFT,39
10-11-2017,10-Nov-17,10-Nov-2017 To Comm.on NEFT:/IBKL-THESVCCO-OPER-004417314054297[ID:5,0,16,-79621676.09,-79621676.09,0,16,True,NEFT,39
10-11-2017,10-Nov-17,10-Nov-2017 To NEFT/IBKL-THE SVCCO-OPER-004417314054301[ID:54301],0,392,-79622068.09,-79622068.09,0,392,True,NEFT,39
10-11-2017,10-Nov-17,10-Nov-2017 To Comm.on NEFT:/IBKL-THESVCCO-OPER-004417314054301[ID:5,0,3,-79622071.09,-79622071.09,0,3,True,NEFT,39
10-11-2017,10-Nov-17,10-Nov-2017 To NEFT/HDFC-ADITYAENGINEER-004417314054295[ID:54295],0,150000,-79772071.09,-79772071.09,0,150000,True,NEFT,39
10-11-2017,10-Nov-17,10-Nov-2017 To Comm.onNEFT:/HDFC-ADITYAENGINEER-004417314054295[ID:,0,16,-79772087.09,-79772087.09,0,16,True,NEFT,39
10-11-2017,10-Nov-17,10-Nov-2017 To NEFT/DNSB-PRINCEFABRICAT-004417314054294[ID:54294],0,198000,-79970087.09,-79970087.09,0,198000,True,NEFT,39
10-11-2017,10-Nov-17,10-Nov-2017 To Comm.onNEFT:/DNSB-PRINCEFABRICAT-004417314054294[ID:,0,16,-79970103.09,-79970103.09,0,16,True,NEFT,39
10-11-2017,10-Nov-17,10-Nov-2017 RUSHABH FASTNERS,0,51673,-80021776.09,-80021776.09,0,51673,True,Others,39
10-11-2017,10-Nov-17,10-Nov-2017 FAITHFUL GOODS CARRIER,0,325100,-80346876.09,-80346876.09,0,325100,True,Others,39
10-11-2017,10-Nov-17,10-Nov-2017 MANIBHADRA TUBECORPORATION10-Nov-2017 KINGS ELECTRONICS PVT LTD,0,48094,-80394970.09,-80394970.09,0,48094,True,Others,39
10-11-2017,10-Nov-17,10-Nov-2017 KINGS ELECTRONICS PVT LTD,0,26500,-80421470.09,-80421470.09,0,26500,True,Others,39
10-11-2017,10-Nov-17,10-Nov-2017 INDO THERM ENGINEERS PVTLTD10-Nov-2017 TATA AIG GEN INS CO LTD,0,200000,-80621470.09,-80621470.09,0,200000,True,Others,39
10-11-2017,10-Nov-17,10-Nov-2017 TATA AIG GEN INS CO LTD,0,95434,-80716904.09,-80716904.09,0,95434,True,Others,39
10-11-2017,10-Nov-17,10-Nov-2017 PRECIOUS MACHINE TOOLS,0,38391,-80755295.09,-80755295.09,0,38391,True,Others,39
10-11-2017,10-Nov-17,10-Nov-2017 JAIAMBE FORGE ENGG PVTLTD10-Nov-2017 OMCAR ENGINEERING WORKS,0,331718,-81087013.09,-81087013.09,0,331718,True,Others,39
10-11-2017,10-Nov-17,10-Nov-2017 OMCAR ENGINEERING WORKS,0,13735,-81100748.09,-81100748.09,0,13735,True,Others,39
10-11-2017,10-Nov-17,10-Nov-2017 SUPERFINE SERVICES,0,10120,-81110868.09,-81110868.09,0,10120,True,Others,39
10-11-2017,10-Nov-17,10-Nov-2017 HINDUSTAN BOLT NUT CO,0,174697,-81285565.09,-81285565.09,0,174697,True,Others,39
10-11-2017,10-Nov-17,10-Nov-2017 S R FABRICATOR,0,39652,-81325217.09,-81325217.09,0,39652,True,Others,39
10-11-2017,10-Nov-17,10-Nov-2017 To NEFT/BARB-MULTIFASTNERS-004417314054317[ID:54317],0,77194,-81402411.09,-81402411.09,0,77194,True,NEFT,39
10-11-2017,10-Nov-17,10-Nov-2017 To Comm.on NEFT:/BARB-MULTIFASTNERS-004417314054317[ID:54317],0,6,-81402417.09,-81402417.09,0,6,True,NEFT,39
10-11-2017,10-Nov-17,10-Nov-2017 To NEFT/HDFC-BAJAJ FINANCEL-004417314054325[ID:54325]10-Nov-2017 To Comm.on NEFT:/HDFC-BAJAJ,0,77577,-81479994.09,-81479994.09,0,77577,True,NEFT,39
10-11-2017,10-Nov-17,10-Nov-2017 To Comm.on NEFT:/HDFC-BAJAJFINANCEL-004417314054325[ID:54325],0,6,-81480000.09,-81480000.09,0,6,True,NEFT,39
10-11-2017,10-Nov-17,10-Nov-2017 To NEFT/UTIB-CHANDANSOUTIA-004417314054318[ID:54318],0,50000,-81530000.09,-81530000.09,0,50000,True,NEFT,39
10-11-2017,10-Nov-17,10-Nov-2017 To Comm.onNEFT:/UTIB-CHANDANSOUTIA-004417314054318[ID:54,0,6,-81530006.09,-81530006.09,0,6,True,NEFT,39
13-11-2017,13-Nov-17,13-Nov-2017 To SI TL/B-LOAN/149,0,101876,-81631882.09,-81631882.09,0,101876,True,ECS,39
13-11-2017,13-Nov-17,13-Nov-2017 BALSONA INDUSTRIAL PAINTS,0,106554,-81738436.09,-81738436.09,0,106554,True,Others,39
13-11-2017,13-Nov-17,13-Nov-2017 AMIT FASTENERS,0,172906,-81911342.09,-81911342.09,0,172906,True,Others,39
13-11-2017,13-Nov-17,13-Nov-2017 SAIRAM DISHEND WORKS,0,38614,-81949956.09,-81949956.09,0,38614,True,Others,39
13-11-2017,13-Nov-17,13-Nov-2017 SHREE KRISHNA DISHINGWORKS13-Nov-2017 RAMAKRISHNA MATH,0,27995,-81977951.09,-81977951.09,0,27995,True,Others,39
13-11-2017,13-Nov-17,13-Nov-2017 RAMAKRISHNA MATH,0,3000,-81980951.09,-81980951.09,0,3000,True,Others,39
13-11-2017,13-Nov-17,13-Nov-2017 To Commission Charged onLC/No.17313-Nov-2017 To Service Charges Charged on,0,12329,-81993280.09,-81993280.09,0,12329,True,CHARGES,39
13-11-2017,13-Nov-17,13-Nov-2017 To Service Charges Charged onLC/No.17313-Nov-2017 To TD/FDL/11390 PART LC,0,1150,-81994430.09,-81994430.09,0,1150,True,CHARGES,39
13-11-2017,13-Nov-17,13-Nov-2017 To TD/FDL/11390 PART LCMARGINDate Particulars,0,2916,-81997346.09,-81997346.09,0,2916,True,Others,39
14-11-2017,14-Nov-17,14-Nov-2017 ATLASMACHINE TOOLS,0,42686,-82040032.09,-82040032.09,0,42686,True,Others,39
14-11-2017,14-Nov-17,14-Nov-2017 PEACEFORT CHEMIND ENGGP LTD14-Nov-2017 J M TRADERS,0,401653,-82441685.09,-82441685.09,0,401653,True,Others,39
14-11-2017,14-Nov-17,14-Nov-2017 J M TRADERS,0,206374,-82648059.09,-82648059.09,0,206374,True,Others,39
14-11-2017,14-Nov-17,14-Nov-2017 SAMBHAV ENTERPRISES,0,124754,-82772813.09,-82772813.09,0,124754,True,Others,39
14-11-2017,14-Nov-17,14-Nov-2017 SHUBHAM PAINTING ANDCONTRACTOR14-Nov-2017 GODAVARI TECHNICAL,0,26661,-82799474.09,-82799474.09,0,26661,True,Others,39
14-11-2017,14-Nov-17,14-Nov-2017 GODAVARI TECHNICALSERVICE14-Nov-2017 DREAM MACHINES,0,57992,-82857466.09,-82857466.09,0,57992,True,Others,39
14-11-2017,14-Nov-17,14-Nov-2017 DREAM MACHINES,0,2550,-82860016.09,-82860016.09,0,2550,True,Others,39
15-11-2017,15-Nov-17,15-Nov-2017 To DECS TP-ICICI B139102959915-Nov-2017 H J PATIL,0,13680,-82873696.09,-82873696.09,0,13680,True,ECS,39
15-11-2017,15-Nov-17,15-Nov-2017 H J PATIL,0,26235,-82899931.09,-82899931.09,0,26235,True,Others,39
15-11-2017,15-Nov-17,15-Nov-2017 SHIV SAI TRANSPORT,0,3000,-82902931.09,-82902931.09,0,3000,True,Others,39
15-11-2017,15-Nov-17,15-Nov-2017 R K TRANSPORT,0,230000,-83132931.09,-83132931.09,0,230000,True,Others,39
15-11-2017,15-Nov-17,15-Nov-2017 NGREEN FIELD MATERIALHANDLING15-Nov-2017 ULTRA TECH INSPECTION,0,85447,-83218378.09,-83218378.09,0,85447,True,Others,39
15-11-2017,15-Nov-17,15-Nov-2017 ULTRA TECH INSPECTIONAGECY15-Nov-2017 OM GASES CHEMICALS,0,39150,-83257528.09,-83257528.09,0,39150,True,Others,39
15-11-2017,15-Nov-17,15-Nov-2017 OM GASES CHEMICALS,0,41551,-83299079.09,-83299079.09,0,41551,True,Others,39
15-11-2017,15-Nov-17,15-Nov-2017 ANJANI STATIONARY,0,1264,-83300343.09,-83300343.09,0,1264,True,Others,39
15-11-2017,15-Nov-17,15-Nov-2017 MSEDCL,0,16230,-83316573.09,-83316573.09,0,16230,True,Others,39
15-11-2017,15-Nov-17,15-Nov-2017 HARMI ENTERPRISES,0,71835,-83388408.09,-83388408.09,0,71835,True,Others,39
15-11-2017,15-Nov-17,15-Nov-2017 ELECTRO DIAGNO SYSTEMSPVT LTD15-Nov-2017 ARABIAN PETROLEUM LIMITED,0,38902,-83427310.09,-83427310.09,0,38902,True,Others,39
15-11-2017,15-Nov-17,15-Nov-2017 ARABIAN PETROLEUM LIMITED,0,3196,-83430506.09,-83430506.09,0,3196,True,Others,39
15-11-2017,15-Nov-17,15-Nov-2017 DOSHI SLITTERS PVT.LTD,0,59058,-83489564.09,-83489564.09,0,59058,True,Others,39
16-11-2017,16-Nov-17,16-Nov-2017 To DECS IILECS,0,85227,-83574791.09,-83574791.09,0,85227,True,ECS,39
16-11-2017,16-Nov-17,16-Nov-2017 WORLD FIRE SAFETY SYSTEM,0,3000,-83577791.09,-83577791.09,0,3000,True,Others,39
16-11-2017,16-Nov-17,16-Nov-2017 EXECUTIVE ENGINEER MIDC,0,2046,-83579837.09,-83579837.09,0,2046,True,Others,39
16-11-2017,16-Nov-17,16-Nov-2017 EXECUTIVE ENGINEER MIDC,0,5582,-83585419.09,-83585419.09,0,5582,True,Others,39
16-11-2017,16-Nov-17,16-Nov-2017 EXECUTIVE ENGINEER MIDC,0,3948,-83589367.09,-83589367.09,0,3948,True,Others,39
16-11-2017,16-Nov-17,16-Nov-2017 SD XEROX,0,1544,-83590911.09,-83590911.09,0,1544,True,Others,39
16-11-2017,16-Nov-17,16-Nov-2017 AO CASH BSNL KALYAN,0,1415,-83592326.09,-83592326.09,0,1415,True,CASH,39
16-11-2017,16-Nov-17,16-Nov-2017 EXECUTIVE ENGINEER MIDC,0,3749,-83596075.09,-83596075.09,0,3749,True,Others,39
16-11-2017,16-Nov-17,16-Nov-2017 AO CASH BSNL KALYAN,0,3353,-83599428.09,-83599428.09,0,3353,True,CASH,39
17-11-2017,17-Nov-17,17-Nov-2017 To NEFT/UTIB-AKSHAYMEHRA-004417321054692[ID:54692],0,15000,-83614428.09,-83614428.09,0,15000,True,NEFT,39
17-11-2017,17-Nov-17,17-Nov-2017 To Comm.onNEFT:/UTIB-AKSHAYMEHRA-004417321054692[ID:54,0,6,-83614434.09,-83614434.09,0,6,True,NEFT,39
17-11-2017,17-Nov-17,17-Nov-2017 INTERTECH FITTINGS INDIA PLTD17-Nov-2017 MTNL,0,93456,-83707890.09,-83707890.09,0,93456,True,Others,39
17-11-2017,17-Nov-17,17-Nov-2017 MTNL,0,2183,-83710073.09,-83710073.09,0,2183,True,Others,39
17-11-2017,17-Nov-17,17-Nov-2017 SHIV SHANKAR ENGINEERS,0,6500,-83716573.09,-83716573.09,0,6500,True,Others,39
17-11-2017,17-Nov-17,17-Nov-2017 GOLDY PROJECTS PVT LTD,0,200000,-83916573.09,-83916573.09,0,200000,True,Others,39
17-11-2017,17-Nov-17,17-Nov-2017 NIMBUS LOGISTICS,0,123000,-84039573.09,-84039573.09,0,123000,True,Others,39
17-11-2017,17-Nov-17,17-Nov-2017 To NEFT/IBKL-THE SVC COOPER-004417321054725[ID:54725],0,95644,-84135217.09,-84135217.09,0,95644,True,NEFT,39
17-11-2017,17-Nov-17,17-Nov-2017 To Comm.on NEFT:/IBKL-THESVC COOPER-004417321054725[ID:5472,0,6,-84135223.09,-84135223.09,0,6,True,NEFT,39
17-11-2017,17-Nov-17,17-Nov-2017 By NEFT ID:54731 [FromNOVATECH PROJECTS (INDIA)PVT LTD],1000000,0,-83135223.09,-83135223.09,1000000,0,True,NEFT,39
18-11-2017,18-Nov-17,18-Nov-2017 To LC-No 152 Retired,0,1614708,-84749931.09,-84749931.09,0,1614708,True,Others,39
18-11-2017,18-Nov-17,18-Nov-2017 To INT 11% P.A. FOR 120 DAYSILC089044000015218-Nov-2017 To Commission Charged on,0,58395,-84808326.09,-84808326.09,0,58395,True,CHARGES,39
18-11-2017,18-Nov-17,18-Nov-2017 To Commission Charged onLC/No.17418-Nov-2017 To Service Charges Charged on,0,27156,-84835482.09,-84835482.09,0,27156,True,CHARGES,39
18-11-2017,18-Nov-17,18-Nov-2017 To Service Charges Charged onLC/No.17420-Nov-2017 By RTGS ID:7973 [From,0,1150,-84836632.09,-84836632.09,0,1150,True,CHARGES,39
20-11-2017,20-Nov-17,20-Nov-2017 By RTGS ID:7973 [From120313023790 NOVATECHPROJECTS (INDIA) PVT LTD 601,1000000,0,-83836632.09,-83836632.09,1000000,0,True,RTGS,39
20-11-2017,20-Nov-17,20-Nov-2017 MATERIAL INSPECTIONTECHNICAL SERVICES20-Nov-2017 RICHA AJAYKUMAR SHARMA,0,8260,-83844892.09,-83844892.09,0,8260,True,Others,39
20-11-2017,20-Nov-17,20-Nov-2017 RICHA AJAYKUMAR SHARMA,0,10000,-83854892.09,-83854892.09,0,10000,True,Others,39
21-11-2017,21-Nov-17,21-Nov-2017 To PO No. Issued.,0,32229,-83887121.09,-83887121.09,0,32229,True,Others,39
21-11-2017,21-Nov-17,21-Nov-2017 To PO No. Issued.,0,27524,-83914645.09,-83914645.09,0,27524,True,Others,39
21-11-2017,21-Nov-17,21-Nov-2017 To PO No. Issued.,0,39640,-83954285.09,-83954285.09,0,39640,True,Others,39
21-11-2017,21-Nov-17,21-Nov-2017 To PO No. Issued.,0,46331,-84000616.09,-84000616.09,0,46331,True,Others,39
21-11-2017,21-Nov-17,21-Nov-2017 To PO No. Issued.,0,52209,-84052825.09,-84052825.09,0,52209,True,Others,39
21-11-2017,21-Nov-17,21-Nov-2017 To Self,0,25000,-84077825.09,-84077825.09,0,25000,True,CASH,39
21-11-2017,21-Nov-17,21-Nov-2017 To NEFT/IBKL-THE SVCCO-OPER-004417325054911[ID:54911],0,23217,-84101042.09,-84101042.09,0,23217,True,NEFT,39
21-11-2017,21-Nov-17,21-Nov-2017 To Comm.on NEFT:/IBKL-THESVCCO-OPER-004417325054911[ID:5,0,6,-84101048.09,-84101048.09,0,6,True,NEFT,39
21-11-2017,21-Nov-17,21-Nov-2017 To NEFT/IBKL-THE SVCCO-OPER-004417325054912[ID:54912],0,12150,-84113198.09,-84113198.09,0,12150,True,NEFT,39
21-11-2017,21-Nov-17,21-Nov-2017 To Comm.on NEFT:/IBKL-THESVCCO-OPER-004417325054912[ID:5,0,6,-84113204.09,-84113204.09,0,6,True,NEFT,39
21-11-2017,21-Nov-17,21-Nov-2017 JOHN GALT INTERNATIONAL,0,500000,-84613204.09,-84613204.09,0,500000,True,Others,39
23-11-2017,23-Nov-17,23-Nov-2017 To Chq.Bk Chgs : 26301-26800,0,600,-84613804.09,-84613804.09,0,600,True,CHARGES,39
23-11-2017,23-Nov-17,23-Nov-2017 MTNL,0,643,-84614447.09,-84614447.09,0,643,True,Others,39
24-11-2017,24-Nov-17,24-Nov-2017 To LC-No 150 Retired,0,78871,-84693318.09,-84693318.09,0,78871,True,Others,39
24-11-2017,24-Nov-17,24-Nov-2017 ALSONS MET INFRA PVT LTD,0,28443,-84721761.09,-84721761.09,0,28443,True,Others,39
24-11-2017,24-Nov-17,24-Nov-2017 TUV SUD SOUTH ASIA PRIVATELTD27-Nov-2017 To SI TL/B-LOAN/180,0,120750,-84842511.09,-84842511.09,0,120750,True,ECS,39
27-11-2017,27-Nov-17,27-Nov-2017 To SI TL/B-LOAN/180,0,14500,-84857011.09,-84857011.09,0,14500,True,ECS,39
27-11-2017,27-Nov-17,27-Nov-2017 To LC-No 150 Retired,0,1633160,-86490171.09,-86490171.09,0,1633160,True,Others,39
27-11-2017,27-Nov-17,27-Nov-2017 To LC-No 162 Retired,0,1847223,-88337394.09,-88337394.09,0,1847223,True,Others,39
27-11-2017,27-Nov-17,27-Nov-2017 To INT @ 9.5% ON LC NO 162 BV STEEL CORPO28-Nov-2017 By RTGS ID:7999 From,0,43271,-88380665.09,-88380665.09,0,43271,True,RTGS,39
28-11-2017,28-Nov-17,28-Nov-2017 By RTGS ID:7999 From120313023790NOVATECHPROJECTS (INDIA) PVT LTD601,5000000,0,-83380665.09,-83380665.09,5000000,0,True,RTGS,39
28-11-2017,28-Nov-17,28-Nov-2017 KAMAL AGENCIES,0,218688,-83599353.09,-83599353.09,0,218688,True,Others,39
28-11-2017,28-Nov-17,28-Nov-2017 CHEMBOND CHEMICALSLIMITED28-Nov-2017 To NEFT/IBKL-NOVATECH,0,150000,-83749353.09,-83749353.09,0,150000,True,NEFT,39
28-11-2017,28-Nov-17,28-Nov-2017 To NEFT/IBKL-NOVATECHPROJEC-004417332055282[ID:55282],0,50000,-83799353.09,-83799353.09,0,50000,True,NEFT,39
28-11-2017,28-Nov-17,28-Nov-2017 To Comm.onNEFT:/IBKL-NOVATECHPROJEC-004417332055282[ID:55,0,6,-83799359.09,-83799359.09,0,6,True,NEFT,39
28-11-2017,28-Nov-17,28-Nov-2017 To NEFT/BARB-SACHIN DINESHP-004417332055299[ID:55299]28-Nov-2017 To Comm.on,0,20000,-83819359.09,-83819359.09,0,20000,True,NEFT,39
28-11-2017,28-Nov-17,28-Nov-2017 To Comm.onNEFT:/BARB-SACHIN DINESHP-004417332055299[ID:55299],0,6,-83819365.09,-83819365.09,0,6,True,NEFT,39
29-11-2017,29-Nov-17,29-Nov-2017 By RTGS ID:8008 [From INHSBC 006-032379-002THYSSENKRUPP INDUSTRIAL,1704033,0,-82115332.09,-82115332.09,1704033,0,True,RTGS,39
30-11-2017,30-Nov-17,"30-Nov-2017 To REAL OF BILLS BHEL 005,006, BER/TAL 00630-Nov-2017 By Mrg",0,2460778,-84576110.09,-84576110.09,0,2460778,True,Others,39
30-11-2017,30-Nov-17,30-Nov-2017 By MrgRev.GEN(BD)7/1125/HundiNo.BHEL 005,30498.9,0,-84545611.19,-84545611.19,30498.900000006,0,True,Others,39
30-11-2017,30-Nov-17,30-Nov-2017 To Hundi No (BHEL 005),0,4546,-84550157.19,-84550157.19,0,4546,True,Others,39
30-11-2017,30-Nov-17,30-Nov-2017 By MrgRev.GEN(BD)7/1126/HundiNo.BHEL 06,98860.4,0,-84451296.79,-84451296.79,98860.3999999911,0,True,Others,39
30-11-2017,30-Nov-17,30-Nov-2017 To Hundi No (BHEL 06),0,14736,-84466032.79,-84466032.79,0,14736,True,Others,39
30-11-2017,30-Nov-17,30-Nov-2017 By MrgRev.GEN(BD)7/1134/HundiNo.BER/TAL/0006,116718.5,0,-84349314.29,-84349314.29,116718.5,0,True,Others,39
30-11-2017,30-Nov-17,30-Nov-2017 To Hundi No (BER/TAL/0006),0,14275,-84363589.29,-84363589.29,0,14275,True,Others,39
30-11-2017,30-Nov-17,30-Nov-2017 To Commission Charged onLC/No.17530-Nov-2017 To Service Charges Charged on,0,18204,-84381793.29,-84381793.29,0,18204,True,CHARGES,39
30-11-2017,30-Nov-17,30-Nov-2017 To Service Charges Charged onLC/No.17530-Nov-2017 PROTEGO INDIA PVT LTD,0,1150,-84382943.29,-84382943.29,0,1150,True,CHARGES,39
30-11-2017,30-Nov-17,30-Nov-2017 PROTEGO INDIA PVT LTD,0,57820,-84440763.29,-84440763.29,0,57820,True,Others,39
30-11-2017,30-Nov-17,30-Nov-2017 By Disc. GEN(BD)7/HundiNo.NPI/AMB/0035A30-Nov-2017 To Disc. GEN(BD)7/Hundi,1389300.3,0,-83051462.99,-83051462.99,1389300.30000001,0,True,Others,39
30-11-2017,30-Nov-17,30-Nov-2017 To Disc. GEN(BD)7/HundiNo.NPI/AMB/0035A30-Nov-2017 By Disc. GEN(BD)7/Hundi,0,27596,-83079058.99,-83079058.99,0,27596,True,Others,39
30-11-2017,30-Nov-17,30-Nov-2017 By Disc. GEN(BD)7/HundiNo.NPI/TAL/001630-Nov-2017 To Disc. GEN(BD)7/Hundi,934414.2,0,-82144644.79,-82144644.79,934414.199999988,0,True,Others,39
30-11-2017,30-Nov-17,30-Nov-2017 To Disc. GEN(BD)7/HundiNo.NPI/TAL/001630-Nov-2017 To NEFT/UTIB-DIPAK,0,24320,-82168964.79,-82168964.79,0,24320,True,NEFT,39
30-11-2017,30-Nov-17,30-Nov-2017 To NEFT/UTIB-DIPAKGHOSH-004417334055432[ID:55432],0,44771,-82213735.79,-82213735.79,0,44771,True,NEFT,39
30-11-2017,30-Nov-17,30-Nov-2017 To Comm.on NEFT:/UTIB-DIPAKGHOSH-004417334055432[ID:55432],0,6,-82213741.79,-82213741.79,0,6,True,NEFT,39
30-11-2017,30-Nov-17,30-Nov-2017 By NEFT ID:55443 [FromGARDEN REACHSHIPBUILDERS AND ENGIN],2419885.63,0,-79793856.16,-79793856.16,2419885.63000001,0,True,NEFT,39
30-11-2017,30-Nov-17,30-Nov-2017 To NEFT/PUNB-JEETENGINEERIN-004417334055438[ID:55438],0,250000,-80043856.16,-80043856.16,0,250000,True,NEFT,39
30-11-2017,30-Nov-17,30-Nov-2017 To Comm.on NEFT:/PUNB-JEETENGINEERIN-004417334055438[ID:55438],0,29,-80043885.16,-80043885.16,0,29,True,NEFT,39
30-11-2017,30-Nov-17,"30-Nov-2017 To REAL OF BILLS BHEL/007,BER/TAL/00430-Nov-2017 By Mrg",0,1977742,-82021627.16,-82021627.16,0,1977742,True,Others,39
30-11-2017,30-Nov-17,30-Nov-2017 By MrgRev.GEN(BD)7/1127/HundiNo.BHEL 07,81055.7,0,-81940571.46,-81940571.46,81055.700000003,0,True,Others,39
30-11-2017,30-Nov-17,30-Nov-2017 To Hundi No (BHEL 07),0,12082,-81952653.46,-81952653.46,0,12082,True,Others,39
30-11-2017,30-Nov-17,30-Nov-2017 By MrgRev.GEN(BD)7/1139/HundiNo.BER/TAL/004,116718.5,0,-81835934.96,-81835934.96,116718.5,0,True,Others,39
30-11-2017,30-Nov-17,30-Nov-2017 To Hundi No (BER/TAL/004),0,18290,-81854224.96,-81854224.96,0,18290,True,Others,39
30-11-2017,30-Nov-17,30-Nov-2017 By Disc. GEN(BD)7/HundiNo.BHEL/09230-Nov-2017 To Disc. GEN(BD)7/Hundi,1516707,0,-80337517.96,-80337517.96,1516707,0,True,Others,39
30-11-2017,30-Nov-17,30-Nov-2017 To Disc. GEN(BD)7/HundiNo.BHEL/092Date Particulars,0,46228,-80383745.96,-80383745.96,0,46228,True,Others,39
30-11-2017,30-Nov-17,30-Nov-2017 To Int. Dr. 01/11/2017-0.0013521431468878201-Dec-2017 To ACH DR KMBLDRAOPE,0,891486,-81275231.96,-81275231.96,0,891486,True,NACH,39
01-12-2017,1-Dec-17,01-Dec-2017 To ACH DR KMBLDRAOPE,0,146889,-81422120.96,-81422120.96,0,146889,True,NACH,39
04-12-2017,4-Dec-17,04-Dec-2017 To ACH DR TP ACH TAT,0,244816,-81666936.96,-81666936.96,0,244816,True,NACH,39
04-12-2017,4-Dec-17,04-Dec-2017 OUTOKUMPU INDIA PVT LTD,0,4680028,-86346964.96,-86346964.96,0,4680028,True,Others,39
04-12-2017,4-Dec-17,04-Dec-2017 To LC/No.174 AmmendmentCharges04-Dec-2017 To Additional Other Charges on,0,11202,-86358166.96,-86358166.96,0,11202,True,CHARGES,39
04-12-2017,4-Dec-17,04-Dec-2017 To Additional Other Charges onLC/No.17405-Dec-2017 By RTGS ID:8036 From,0,1150,-86359316.96,-86359316.96,0,1150,True,CHARGES,39
05-12-2017,5-Dec-17,05-Dec-2017 By RTGS ID:8036 From24605053424M/S NOVATECHPROJECTS (I) PRIVATE,4000000,0,-82359316.96,-82359316.96,4000000,0,True,RTGS,39
05-12-2017,5-Dec-17,05-Dec-2017 To ACH DR IVL FINANC,0,179511,-82538827.96,-82538827.96,0,179511,True,NACH,39
05-12-2017,5-Dec-17,05-Dec-2017 To ACH DR HDFC BANK,0,19408,-82558235.96,-82558235.96,0,19408,True,NACH,39
05-12-2017,5-Dec-17,05-Dec-2017 To ACH DR ADITY BIRL,0,203544,-82761779.96,-82761779.96,0,203544,True,NACH,39
05-12-2017,5-Dec-17,05-Dec-2017 To ACH DR BDACH-RTBN,0,98440,-82860219.96,-82860219.96,0,98440,True,NACH,39
05-12-2017,5-Dec-17,"05-Dec-2017 To REALISATION OF BILLSRFCL-014, EIL-01505-Dec-2017 By Mrg",0,1632521,-84492740.96,-84492740.96,0,1632521,True,Others,39
05-12-2017,5-Dec-17,05-Dec-2017 By MrgRev.GEN(BD)7/1149/HundiNo.RFCL/014,50250.2,0,-84442490.76,-84442490.76,50250.1999999881,0,True,Others,39
05-12-2017,5-Dec-17,05-Dec-2017 To Hundi No (RFCL/014),0,6530,-84449020.76,-84449020.76,0,6530,True,Others,39
05-12-2017,5-Dec-17,05-Dec-2017 By MrgRev.GEN(BD)7/1154/HundiNo.EIL/015,113001.9,0,-84336018.86,-84336018.86,113001.900000006,0,True,Others,39
05-12-2017,5-Dec-17,05-Dec-2017 To Hundi No (EIL/015),0,12093,-84348111.86,-84348111.86,0,12093,True,Others,39
05-12-2017,5-Dec-17,05-Dec-2017 By NEFT ID:55775 [FromRAMAGUNDAM FERTILIZERSAN],1758750,0,-82589361.86,-82589361.86,1758750,0,True,NEFT,39
05-12-2017,5-Dec-17,05-Dec-2017 To NEFT/ICIC-VIRTUALBUSINES-004417339055779[ID:55779],0,21812,-82611173.86,-82611173.86,0,21812,True,NEFT,39
05-12-2017,5-Dec-17,05-Dec-2017 To Comm.onNEFT:/ICIC-VIRTUALBUSINES-004417339055779[ID:5,0,6,-82611179.86,-82611179.86,0,6,True,NEFT,39
06-12-2017,6-Dec-17,06-Dec-2017 To LC PAYMENT LC NO 150PARAMOUNT FORGE06-Dec-2017 To RTGS[ID:8045 For,0,108009,-82719188.86,-82719188.86,0,108009,True,RTGS,39
06-12-2017,6-Dec-17,06-Dec-2017 To RTGS[ID:8045 For08732120001884 SEVAGIRICONTRACTOR],0,200000,-82919188.86,-82919188.86,0,200000,True,RTGS,39
06-12-2017,6-Dec-17,06-Dec-2017 To Comm. on RTGS[ID:8045 For08732120001884 SEVAGIRICONTRACTOR],0,35,-82919223.86,-82919223.86,0,35,True,RTGS,39
06-12-2017,6-Dec-17,06-Dec-2017 To RTGS[ID:8044 For911020004897100 QUALITYENGINEERS AND SERVICES],0,300000,-83219223.86,-83219223.86,0,300000,True,RTGS,39
06-12-2017,6-Dec-17,06-Dec-2017 To Comm. on RTGS[ID:8044 For911020004897100 QUALITYENGINEERS AND SERVICES],0,35,-83219258.86,-83219258.86,0,35,True,RTGS,39
06-12-2017,6-Dec-17,06-Dec-2017 To RTGS[ID:8046 For4138002100012707 JEETENGINEERING],0,250000,-83469258.86,-83469258.86,0,250000,True,RTGS,39
06-12-2017,6-Dec-17,06-Dec-2017 To Comm. on RTGS[ID:8046 For4138002100012707 JEETENGINEERING],0,35,-83469293.86,-83469293.86,0,35,True,RTGS,39
06-12-2017,6-Dec-17,06-Dec-2017 JOHN GALT INTERNATIONAL,0,400000,-83869293.86,-83869293.86,0,400000,True,Others,39
06-12-2017,6-Dec-17,06-Dec-2017 To NEFT/ICIC-FULLERTONINDIA-004417340055849[ID:55849],0,246012,-84115305.86,-84115305.86,0,246012,True,NEFT,39
06-12-2017,6-Dec-17,06-Dec-2017 To Comm.onNEFT:/ICIC-FULLERTONINDIA-004417340055849[ID:5584,0,29,-84115334.86,-84115334.86,0,29,True,NEFT,39
06-12-2017,6-Dec-17,06-Dec-2017 To STOCK AUDIT CHGS,0,8532,-84123866.86,-84123866.86,0,8532,True,CHARGES,39
07-12-2017,7-Dec-17,07-Dec-2017 To DECS HDFC BANK4623922307-Dec-2017 To ACH DR MAGMAFINCO,0,11900,-84135766.86,-84135766.86,0,11900,True,ECS,39
07-12-2017,7-Dec-17,07-Dec-2017 To ACH DR MAGMAFINCO,0,121329,-84257095.86,-84257095.86,0,121329,True,NACH,39
07-12-2017,7-Dec-17,07-Dec-2017 To ACH DR MAGMAFINCO,0,161578,-84418673.86,-84418673.86,0,161578,True,NACH,39
07-12-2017,7-Dec-17,07-Dec-2017 By RTGS ID:8049 From120313023790NOVATECHPROJECTS (INDIA) PVT LTD601,2500000,0,-81918673.86,-81918673.86,2500000,0,True,RTGS,39
07-12-2017,7-Dec-17,"07-Dec-2017 To REAL OF BILLSBER/TAL/008, BER/AMB/02007-Dec-2017 By Mrg",0,2851277,-84769950.86,-84769950.86,0,2851277,True,Others,39
07-12-2017,7-Dec-17,07-Dec-2017 By MrgRev.GEN(BD)7/1145/HundiNo.BER/TAL/008,172505.2,0,-84597445.66,-84597445.66,172505.200000003,0,True,Others,39
07-12-2017,7-Dec-17,07-Dec-2017 To Hundi No (BER/TAL/008),0,7252,-84604697.66,-84604697.66,0,7252,True,Others,39
07-12-2017,7-Dec-17,07-Dec-2017 By MrgRev.GEN(BD)7/1157/HundiNo.BER/AMB/20,112622.5,0,-84492075.16,-84492075.16,112622.5,0,True,Others,39
07-12-2017,7-Dec-17,07-Dec-2017 To Hundi No (BER/AMB/20),0,4735,-84496810.16,-84496810.16,0,4735,True,Others,39
07-12-2017,7-Dec-17,07-Dec-2017 By Disc. GEN(BD)7/HundiNo.NPI/TAL/001707-Dec-2017 To Disc. GEN(BD)7/Hundi,2561522.4,0,-81935287.76,-81935287.76,2561522.39999999,0,True,Others,39
07-12-2017,7-Dec-17,07-Dec-2017 To Disc. GEN(BD)7/HundiNo.NPI/TAL/001707-Dec-2017 To NEFT/YESB-PASSIM,0,60529,-81995816.76,-81995816.76,0,60529,True,NEFT,39
07-12-2017,7-Dec-17,07-Dec-2017 To NEFT/YESB-PASSIMENGINEER-004417341055935[ID:55935],0,300000,-82295816.76,-82295816.76,0,300000,True,NEFT,39
07-12-2017,7-Dec-17,07-Dec-2017 To Comm.onNEFT:/YESB-PASSIMENGINEER-004417341055935[ID:,0,29,-82295845.76,-82295845.76,0,29,True,NEFT,39
07-12-2017,7-Dec-17,07-Dec-2017 By Disc. GEN(BD)7/HundiNo.NPI/TAL/001807-Dec-2017 To Disc. GEN(BD)7/Hundi,1280761.2,0,-81015084.56,-81015084.56,1280761.2,0,True,Others,39
07-12-2017,7-Dec-17,07-Dec-2017 To Disc. GEN(BD)7/HundiNo.NPI/TAL/0018Date Particulars,0,38160,-81053244.56,-81053244.56,0,38160,True,Others,39
08-12-2017,8-Dec-17,08-Dec-2017 To Self,0,65000,-81118244.56,-81118244.56,0,65000,True,CASH,39
08-12-2017,8-Dec-17,"08-Dec-2017 To DORV PROCESSEQUIPMETNS PVT LTD08-Dec-2017 To REAL OF BILLS BHEL 044,",0,120000,-81238244.56,-81238244.56,0,120000,True,Others,39
08-12-2017,8-Dec-17,"08-Dec-2017 To REAL OF BILLS BHEL 044,BER/00908-Dec-2017 By Mrg",0,3273585,-84511829.56,-84511829.56,0,3273585,True,Others,39
08-12-2017,8-Dec-17,08-Dec-2017 By MrgRev.GEN(BD)7/1141/HundiNo.BHEL/044,172479.8,0,-84339349.76,-84339349.76,172479.799999997,0,True,Others,39
08-12-2017,8-Dec-17,08-Dec-2017 To Hundi No (BHEL/044),0,6592,-84345941.76,-84345941.76,0,6592,True,Others,39
08-12-2017,8-Dec-17,08-Dec-2017 By MrgRev.GEN(BD)7/1147/HundiNo.BER/009,154878.7,0,-84191063.06,-84191063.06,154878.700000003,0,True,Others,39
08-12-2017,8-Dec-17,08-Dec-2017 To Hundi No (BER/009),0,5919,-84196982.06,-84196982.06,0,5919,True,Others,39
08-12-2017,8-Dec-17,08-Dec-2017 AKSHAR JYOTI,0,8512,-84205494.06,-84205494.06,0,8512,True,Others,39
08-12-2017,8-Dec-17,08-Dec-2017 To NEFT/BARB-AMANPETROLEUM-004417342056008[ID:56008],0,221134,-84426628.06,-84426628.06,0,221134,True,NEFT,39
08-12-2017,8-Dec-17,08-Dec-2017 To Comm.on NEFT:/BARB-AMANPETROLEUM-004417342056008[ID:56008],0,29,-84426657.06,-84426657.06,0,29,True,NEFT,39
08-12-2017,8-Dec-17,08-Dec-2017 To NEFT/UTIB-WEIZMANNFOREX-004417342056007[ID:56007],0,98224,-84524881.06,-84524881.06,0,98224,True,NEFT,39
08-12-2017,8-Dec-17,08-Dec-2017 To Comm.onNEFT:/UTIB-WEIZMANN FOREX-004417342056007[ID:56007],0,6,-84524887.06,-84524887.06,0,6,True,NEFT,39
08-12-2017,8-Dec-17,08-Dec-2017 By Disc. GEN(BD)7/HundiNo.362874808-Dec-2017 To Disc. GEN(BD)7/Hundi,3265873.2,0,-81259013.86,-81259013.86,3265873.2,0,True,Others,39
08-12-2017,8-Dec-17,08-Dec-2017 To Disc. GEN(BD)7/HundiNo.362874811-Dec-2017 To SI TL/B-LOAN/149,0,93950,-81352963.86,-81352963.86,0,93950,True,ECS,39
11-12-2017,11-Dec-17,11-Dec-2017 To SI TL/B-LOAN/149,0,101876,-81454839.86,-81454839.86,0,101876,True,ECS,39
11-12-2017,11-Dec-17,11-Dec-2017 To Stop Pmt.(24640-24640),0,150,-81454989.86,-81454989.86,0,150,True,Others,39
11-12-2017,11-Dec-17,11-Dec-2017 To SIGN VERIFICATION CHGS,0,75,-81455064.86,-81455064.86,0,75,True,CHARGES,39
11-12-2017,11-Dec-17,11-Dec-2017 To ROC SEARCH & FILINGFEES - NOVATECH PROJECTS I11-Dec-2017 To ROC SEARCH & FILING,0,2814,-81457878.86,-81457878.86,0,2814,True,Others,39
11-12-2017,11-Dec-17,11-Dec-2017 To ROC SEARCH & FILINGFEES - DROV PROCESSEQUIPME,0,2678,-81460556.86,-81460556.86,0,2678,True,Others,39
11-12-2017,11-Dec-17,11-Dec-2017 To NEFT/SCBL-NOVATECHPROJEC-004417345056135[ID:56135],0,250000,-81710556.86,-81710556.86,0,250000,True,NEFT,39
11-12-2017,11-Dec-17,11-Dec-2017 To Comm.onNEFT:/SCBL-NOVATECHPROJEC-004417345056135[ID:56,0,29,-81710585.86,-81710585.86,0,29,True,NEFT,39
11-12-2017,11-Dec-17,11-Dec-2017 To NEFT/CNRB-ANANTAPRASADL-004417345056137[ID:56137],0,42728,-81753313.86,-81753313.86,0,42728,True,NEFT,39
11-12-2017,11-Dec-17,11-Dec-2017 To Comm.onNEFT:/CNRB-ANANTA PRASADL-004417345056137[ID:56137],0,6,-81753319.86,-81753319.86,0,6,True,NEFT,39
11-12-2017,11-Dec-17,11-Dec-2017 To NEFT/UTIB-TRIO INFOTECHS-004417345056145[ID:56145]11-Dec-2017 To Comm.on NEFT:/UTIB-TRIO,0,162000,-81915319.86,-81915319.86,0,162000,True,NEFT,39
11-12-2017,11-Dec-17,11-Dec-2017 To Comm.on NEFT:/UTIB-TRIOINFOTECHS-004417345056145[ID:56145],0,16,-81915335.86,-81915335.86,0,16,True,NEFT,39
11-12-2017,11-Dec-17,11-Dec-2017 To NEFT/UTIB-ROHITBHOIR-004417345056146[ID:56146],0,46208,-81961543.86,-81961543.86,0,46208,True,NEFT,39
11-12-2017,11-Dec-17,11-Dec-2017 To Comm.on NEFT:/UTIB-ROHITBHOIR-004417345056146[ID:56146],0,6,-81961549.86,-81961549.86,0,6,True,NEFT,39
12-12-2017,12-Dec-17,12-Dec-2017 To NEFT/SCBL-NOVATECHPROJEC-004417346056197[ID:56197],0,150000,-82111549.86,-82111549.86,0,150000,True,NEFT,39
12-12-2017,12-Dec-17,12-Dec-2017 To Comm.onNEFT:/SCBL-NOVATECHPROJEC-004417346056197[ID:56,0,16,-82111565.86,-82111565.86,0,16,True,NEFT,39
12-12-2017,12-Dec-17,12-Dec-2017 VIJAY ENGINEERING SERVICE,0,17170,-82128735.86,-82128735.86,0,17170,True,Others,39
12-12-2017,12-Dec-17,12-Dec-2017 SUPERFLOW  PVT LTD,0,300000,-82428735.86,-82428735.86,0,300000,True,Others,39
13-12-2017,13-Dec-17,13-Dec-2017 APS POWER SYSTEMS PVTLTD13-Dec-2017 SOHM ANALYTICAL SERVICES,0,20060,-82448795.86,-82448795.86,0,20060,True,Others,39
13-12-2017,13-Dec-17,13-Dec-2017 SOHM ANALYTICAL SERVICES,0,114415,-82563210.86,-82563210.86,0,114415,True,Others,39
13-12-2017,13-Dec-17,13-Dec-2017 PATIL HARICHANDRA JOMA,0,26235,-82589445.86,-82589445.86,0,26235,True,Others,39
13-12-2017,13-Dec-17,13-Dec-2017 To LC ISSU CHGS- 0000825AXIS13-Dec-2017 To LC SFMS CHGS- 0000825,0,11681,-82601126.86,-82601126.86,0,11681,True,CHARGES,39
13-12-2017,13-Dec-17,13-Dec-2017 To LC SFMS CHGS- 0000825AXIS13-Dec-2017 To LC COMM/ISS CHGS-,0,150,-82601276.86,-82601276.86,0,150,True,CHARGES,39
13-12-2017,13-Dec-17,13-Dec-2017 To LC COMM/ISS CHGS-0000832 AXIS13-Dec-2017 To LC SFMS CHGS/ISS 0000832,0,10166,-82611442.86,-82611442.86,0,10166,True,CHARGES,39
13-12-2017,13-Dec-17,13-Dec-2017 To LC SFMS CHGS/ISS 0000832AXIS13-Dec-2017 To LC IBC 1880 AXIS,0,150,-82611592.86,-82611592.86,0,150,True,CHARGES,39
13-12-2017,13-Dec-17,13-Dec-2017 To LC IBC 1880 AXIS,0,150,-82611742.86,-82611742.86,0,150,True,Others,39
13-12-2017,13-Dec-17,13-Dec-2017 To LC COMM/AMND 0000832AXIS13-Dec-2017 To LC SFMS CHGS/AMND,0,750,-82612492.86,-82612492.86,0,750,True,CHARGES,39
13-12-2017,13-Dec-17,13-Dec-2017 To LC SFMS CHGS/AMND0000832 AXIS13-Dec-2017 To LC IBC 1880 AXIS,0,150,-82612642.86,-82612642.86,0,150,True,CHARGES,39
13-12-2017,13-Dec-17,13-Dec-2017 To LC IBC 1880 AXIS,0,150,-82612792.86,-82612792.86,0,150,True,Others,39
13-12-2017,13-Dec-17,13-Dec-2017 To LC BG COMM 4742 AXIS,0,1933.33,-82614726.19,-82614726.19,0,1933.32999999821,True,Others,39
13-12-2017,13-Dec-17,13-Dec-2017 To LC BG ISS 4742 AXIS,0,118,-82614844.19,-82614844.19,0,118,True,Others,39
13-12-2017,13-Dec-17,13-Dec-2017 To LC IBC 1887 AXIS,0,150,-82614994.19,-82614994.19,0,150,True,Others,39
13-12-2017,13-Dec-17,13-Dec-2017 To LC IBC 1887 AXIS,0,150,-82615144.19,-82615144.19,0,150,True,Others,39
14-12-2017,14-Dec-17,14-Dec-2017 To NEFT/INDB-INDUSIND BANKL-004417348056341[ID:56341]14-Dec-2017 To Comm.on,0,180136,-82795280.19,-82795280.19,0,180136,True,NEFT,39
14-12-2017,14-Dec-17,14-Dec-2017 To Comm.onNEFT:/INDB-INDUSIND BANKL-004417348056341[ID:56341],0,16,-82795296.19,-82795296.19,0,16,True,NEFT,39
14-12-2017,14-Dec-17,14-Dec-2017 BANGAL AUTO GARAGEDate Particulars14-Dec-2017 By RTGS ID:8077 [From,0,14000,-82809296.19,-82809296.19,0,14000,True,RTGS,39
14-12-2017,14-Dec-17,14-Dec-2017 By RTGS ID:8077 [From140310000725BERGERAUTOANDINDUSTRIAL,2484339,0,-80324957.19,-80324957.19,2484339,0,True,RTGS,39
14-12-2017,14-Dec-17,14-Dec-2017 By NEFT ID:56380 [FromRAMAGUNDAM FERTILIZERSAND CHEMICAL],189765,0,-80135192.19,-80135192.19,189765,0,True,NEFT,39
14-12-2017,14-Dec-17,14-Dec-2017 To NEFT/IBKL-PRANKRISHNASAN-004417348056342[ID:56342]14-Dec-2017 To Comm.on,0,32000,-80167192.19,-80167192.19,0,32000,True,NEFT,39
14-12-2017,14-Dec-17,14-Dec-2017 To Comm.onNEFT:/IBKL-PRANKRISHNASAN-004417348056342[ID:56342],0,6,-80167198.19,-80167198.19,0,6,True,NEFT,39
15-12-2017,15-Dec-17,15-Dec-2017 To DECS TP-ICICI B140169379215-Dec-2017 To Self,0,13680,-80180878.19,-80180878.19,0,13680,True,ECS,39
15-12-2017,15-Dec-17,15-Dec-2017 To Self,0,15000,-80195878.19,-80195878.19,0,15000,True,CASH,39
15-12-2017,15-Dec-17,15-Dec-2017 To RTGS[ID:8081 For24605053424 NOVATECHPROJECTS I PVT LTD],0,2200000,-82395878.19,-82395878.19,0,2200000,True,RTGS,39
15-12-2017,15-Dec-17,15-Dec-2017 To Comm. on RTGS[ID:8081 For24605053424 NOVATECHPROJECTS I PVT LTD],0,60,-82395938.19,-82395938.19,0,60,True,RTGS,39
15-12-2017,15-Dec-17,15-Dec-2017 By RTGS ID:8083 [From140310000725BERGERAUTOANDINDUSTRIAL,2484339,0,-79911599.19,-79911599.19,2484339,0,True,RTGS,39
15-12-2017,15-Dec-17,15-Dec-2017 MESSIAH AIR COOL SERVICE,0,4130,-79915729.19,-79915729.19,0,4130,True,Others,39
15-12-2017,15-Dec-17,15-Dec-2017 To NEFT/BARB-OMCONSULTINGS-004417349056447[ID:56447],0,1800000,-81715729.19,-81715729.19,0,1800000,True,NEFT,39
15-12-2017,15-Dec-17,15-Dec-2017 To Comm.on NEFT:/BARB-OMCONSULTINGS-004417349056447[ID:56447],0,29,-81715758.19,-81715758.19,0,29,True,NEFT,39
16-12-2017,16-Dec-17,16-Dec-2017 To DECS IILECS,0,85227,-81800985.19,-81800985.19,0,85227,True,ECS,39
16-12-2017,16-Dec-17,16-Dec-2017 FAITHFUL GOODS CARRIER,0,367500,-82168485.19,-82168485.19,0,367500,True,Others,39
18-12-2017,18-Dec-17,18-Dec-2017 By RTGS ID:8090 From120313023790NOVATECHPROJECTS (INDIA) PVT LTD601,5500000,0,-76668485.19,-76668485.19,5500000,0,True,RTGS,39
18-12-2017,18-Dec-17,"18-Dec-2017 To REAL OF BILLSBER/AMB/011, BER/TAL/00518-Dec-2017 By Mrg",0,7359970,-84028455.19,-84028455.19,0,7359970,True,Others,39
18-12-2017,18-Dec-17,18-Dec-2017 By MrgRev.GEN(BD)7/1132/HundiNo.BER/AMB/011,324349,0,-83704106.19,-83704106.19,324349,0,True,Others,39
18-12-2017,18-Dec-17,18-Dec-2017 To Hundi No (BER/AMB/011),0,66940,-83771046.19,-83771046.19,0,66940,True,Others,39
18-12-2017,18-Dec-17,18-Dec-2017 By MrgRev.GEN(BD)7/1140/HundiNo.BER/TAL/0005,411648,0,-83359398.19,-83359398.19,411648,0,True,Others,39
18-12-2017,18-Dec-17,18-Dec-2017 To Hundi No (BER/TAL/0005)Date Particulars18-Dec-2017 AP CLEANING WORKS,0,86531,-83445929.19,-83445929.19,0,86531,True,Others,39
18-12-2017,18-Dec-17,18-Dec-2017 AP CLEANING WORKS,0,207986,-83653915.19,-83653915.19,0,207986,True,Others,39
18-12-2017,18-Dec-17,18-Dec-2017 To PAY ORDERS MSEDC COLTD18-Dec-2017 To PAY ORDER CHGS -,0,228490,-83882405.19,-83882405.19,0,228490,True,CHARGES,39
18-12-2017,18-Dec-17,18-Dec-2017 To PAY ORDER CHGS -M.S.E.D. CO. LTD.18-Dec-2017 To PAY ORDER CHGS -,0,147,-83882552.19,-83882552.19,0,147,True,CHARGES,39
18-12-2017,18-Dec-17,18-Dec-2017 To PAY ORDER CHGS -M.S.E.D. CO. LTD.18-Dec-2017 To PAY ORDER CHGS -,0,135,-83882687.19,-83882687.19,0,135,True,CHARGES,39
18-12-2017,18-Dec-17,18-Dec-2017 To PAY ORDER CHGS -M.S.E.D. CO. LTD.18-Dec-2017 To PAY ORDER CHGS -,0,105,-83882792.19,-83882792.19,0,105,True,CHARGES,39
18-12-2017,18-Dec-17,18-Dec-2017 To PAY ORDER CHGS -M.S.E.D. CO. LTD.18-Dec-2017 To PAY ORDER CHGS -,0,123,-83882915.19,-83882915.19,0,123,True,CHARGES,39
18-12-2017,18-Dec-17,18-Dec-2017 To PAY ORDER CHGS -M.S.E.D. CO. LTD.18-Dec-2017 To NEFT/HDFC-DESHMUKH,0,186,-83883101.19,-83883101.19,0,186,True,CHARGES,39
18-12-2017,18-Dec-17,18-Dec-2017 To NEFT/HDFC-DESHMUKHENGGC-004417352056607[ID:56607],0,19116,-83902217.19,-83902217.19,0,19116,True,NEFT,39
18-12-2017,18-Dec-17,18-Dec-2017 To Comm.onNEFT:/HDFC-DESHMUKH ENGGC-004417352056607[ID:56607],0,6,-83902223.19,-83902223.19,0,6,True,NEFT,39
18-12-2017,18-Dec-17,18-Dec-2017 To NEFT/VIJB-SHREE SAINATHC-004417352056604[ID:56604]18-Dec-2017 To Comm.on NEFT:/VIJB-SHREE,0,28134,-83930357.19,-83930357.19,0,28134,True,NEFT,39
18-12-2017,18-Dec-17,18-Dec-2017 To Comm.on NEFT:/VIJB-SHREESAINATHC-004417352056604[ID:56604],0,6,-83930363.19,-83930363.19,0,6,True,NEFT,39
18-12-2017,18-Dec-17,18-Dec-2017 By Disc. GEN(BD)7/HundiNo.BERGER/001918-Dec-2017 To Disc. GEN(BD)7/Hundi,1346148,0,-82584215.19,-82584215.19,1346148,0,True,Others,39
18-12-2017,18-Dec-17,18-Dec-2017 To Disc. GEN(BD)7/HundiNo.BERGER/001918-Dec-2017 By Disc. GEN(BD)7/Hundi,0,38264,-82622479.19,-82622479.19,0,38264,True,Others,39
18-12-2017,18-Dec-17,18-Dec-2017 By Disc. GEN(BD)7/HundiNo.BERGER/002018-Dec-2017 To Disc. GEN(BD)7/Hundi,1126589.4,0,-81495889.79,-81495889.79,1126589.39999999,0,True,Others,39
18-12-2017,18-Dec-17,18-Dec-2017 To Disc. GEN(BD)7/HundiNo.BERGER/002018-Dec-2017 By NEFT ID:56619 [From,0,32023,-81527912.79,-81527912.79,0,32023,True,NEFT,39
18-12-2017,18-Dec-17,18-Dec-2017 By NEFT ID:56619 [FromDECCAN FINE CHEMICALSINDIA PVT LTD],290000,0,-81237912.79,-81237912.79,290000,0,True,NEFT,39
18-12-2017,18-Dec-17,18-Dec-2017 By Disc. GEN(BD)7/HundiNo.BGR/75M18-Dec-2017 To Disc. GEN(BD)7/Hundi,1337494.5,0,-79900418.29,-79900418.29,1337494.5,0,True,Others,39
18-12-2017,18-Dec-17,18-Dec-2017 To Disc. GEN(BD)7/HundiNo.BGR/75M18-Dec-2017 To Self,0,34812,-79935230.29,-79935230.29,0,34812,True,CASH,39
18-12-2017,18-Dec-17,18-Dec-2017 To Self,0,35000,-79970230.29,-79970230.29,0,35000,True,CASH,39
18-12-2017,18-Dec-17,18-Dec-2017 By Disc. GEN(BD)7/HundiNo.BHEL/09318-Dec-2017 To Disc. GEN(BD)7/Hundi,1504233,0,-78465997.29,-78465997.29,1504233,0,True,Others,39
18-12-2017,18-Dec-17,18-Dec-2017 To Disc. GEN(BD)7/HundiNo.BHEL/09318-Dec-2017 By NEFT/UTIB-SUKUMAR,0,37091,-78503088.29,-78503088.29,0,37091,True,NEFT,39
18-12-2017,18-Dec-17,18-Dec-2017 By NEFT/UTIB-SUKUMARKALIPAD-AXSK173520031488[ID:56632],3000000,0,-75503088.29,-75503088.29,3000000,0,True,NEFT,39
19-12-2017,19-Dec-17,19-Dec-2017 To LC-No 156 Retired,0,682679,-76185767.29,-76185767.29,0,682679,True,Others,39
19-12-2017,19-Dec-17,"19-Dec-2017 To INT 9% PA FOR 120 DAYSON LC NO 156 GEE LTD19-Dec-2017 To REAL OF BILLS BER/TAL/07,",0,20200,-76205967.29,-76205967.29,0,20200,True,Others,39
19-12-2017,19-Dec-17,"19-Dec-2017 To REAL OF BILLS BER/TAL/07,RFCL/0017Date Particulars",0,8304000,-84509967.29,-84509967.29,0,8304000,True,Others,39
19-12-2017,19-Dec-17,19-Dec-2017 By MrgRev.GEN(BD)7/1135/HundiNo.BER/TAL/00007,411648,0,-84098319.29,-84098319.29,411648,0,True,Others,39
19-12-2017,19-Dec-17,19-Dec-2017 To Hundi No (BER/TAL/00007),0,70798,-84169117.29,-84169117.29,0,70798,True,Others,39
19-12-2017,19-Dec-17,19-Dec-2017 By MrgRev.GEN(BD)7/1146/HundiNo.RFCL/0017,418752,0,-83750365.29,-83750365.29,418752,0,True,Others,39
19-12-2017,19-Dec-17,19-Dec-2017 To Hundi No (RFCL/0017),0,54415,-83804780.29,-83804780.29,0,54415,True,Others,39
19-12-2017,19-Dec-17,19-Dec-2017 By Disc. GEN(BD)7/HundiNo.NPI/AMB/004319-Dec-2017 To Disc. GEN(BD)7/Hundi,6560262,0,-77244518.29,-77244518.29,6560262,0,True,Others,39
19-12-2017,19-Dec-17,19-Dec-2017 To Disc. GEN(BD)7/HundiNo.NPI/AMB/004319-Dec-2017 By NEFT/SBIN-RAMAGUNDAM,0,170747,-77415265.29,-77415265.29,0,170747,True,NEFT,39
19-12-2017,19-Dec-17,19-Dec-2017 By NEFT/SBIN-RAMAGUNDAMFERT-SBIN417353434124[ID:56697],2919217,0,-74496048.29,-74496048.29,2919217,0,True,NEFT,39
19-12-2017,19-Dec-17,19-Dec-2017 By Transfer TD/FDS/2869,14898,0,-74481150.29,-74481150.29,14898,0,True,Others,39
20-12-2017,20-Dec-17,20-Dec-2017 To LC-No 157 Retired,0,10000635,-84481785.29,-84481785.29,0,10000635,True,Others,39
20-12-2017,20-Dec-17,20-Dec-2017 To Commission Charged onLC/No.18720-Dec-2017 To Service Charges Charged on,0,186441,-84668226.29,-84668226.29,0,186441,True,CHARGES,39
20-12-2017,20-Dec-17,20-Dec-2017 To Service Charges Charged onLC/No.18720-Dec-2017 CHEMFAB ENGINEERING,0,1150,-84669376.29,-84669376.29,0,1150,True,CHARGES,39
20-12-2017,20-Dec-17,20-Dec-2017 CHEMFAB ENGINEERINGCORP20-Dec-2017 By Disc. GEN(BD)7/Hundi,0,37240,-84706616.29,-84706616.29,0,37240,True,Others,39
20-12-2017,20-Dec-17,20-Dec-2017 By Disc. GEN(BD)7/HundiNo.GRSE/R-00520-Dec-2017 To Disc. GEN(BD)7/Hundi,2390816.7,0,-82315799.59,-82315799.59,2390816.7,0,True,Others,39
20-12-2017,20-Dec-17,20-Dec-2017 To Disc. GEN(BD)7/HundiNo.GRSE/R-00520-Dec-2017 To NEFT/DEUT-TATA AIG,0,57314,-82373113.59,-82373113.59,0,57314,True,NEFT,39
20-12-2017,20-Dec-17,20-Dec-2017 To NEFT/DEUT-TATA AIGGENERA-004417354056768[ID:56768],0,5900,-82379013.59,-82379013.59,0,5900,True,NEFT,39
20-12-2017,20-Dec-17,20-Dec-2017 To Comm.on NEFT:/DEUT-TATAAIGGENERA-004417354056768[ID:5,0,3,-82379016.59,-82379016.59,0,3,True,NEFT,39
20-12-2017,20-Dec-17,20-Dec-2017 To NEFT/PUNB-JEETENGINEERIN-004417354056772[ID:56772],0,500000,-82879016.59,-82879016.59,0,500000,True,NEFT,39
20-12-2017,20-Dec-17,20-Dec-2017 To Comm.on NEFT:/PUNB-JEETENGINEERIN-004417354056772[ID:56772],0,29,-82879045.59,-82879045.59,0,29,True,NEFT,39
21-12-2017,21-Dec-17,21-Dec-2017 By RTGS ID:8107 [From120313023790 NOVATECHPROJECTS (INDIA) PVT LTD 601,2000000,0,-80879045.59,-80879045.59,2000000,0,True,RTGS,39
21-12-2017,21-Dec-17,21-Dec-2017 To LC-No 160 Retired,0,2370995,-83250040.59,-83250040.59,0,2370995,True,Others,39
21-12-2017,21-Dec-17,21-Dec-2017 To INT @ 9% P.A. FOR 120DAYS LC NO 160Date Particulars,0,70155,-83320195.59,-83320195.59,0,70155,True,Others,39
21-12-2017,21-Dec-17,21-Dec-2017 By RTGS ID:8110 [From35912958425 BGR ENERGYSYSTEMS LIMITED 443 ANNA,883655,0,-82436540.59,-82436540.59,883655,0,True,RTGS,39
21-12-2017,21-Dec-17,21-Dec-2017 SRI BALAJI LOGISTIC,0,251645,-82688185.59,-82688185.59,0,251645,True,Others,39
21-12-2017,21-Dec-17,21-Dec-2017 MSEDCL,0,33810,-82721995.59,-82721995.59,0,33810,True,Others,39
21-12-2017,21-Dec-17,21-Dec-2017 BRITEX ENGINEERING WORKS,0,19859,-82741854.59,-82741854.59,0,19859,True,Others,39
21-12-2017,21-Dec-17,21-Dec-2017 NAVKAR FITTINGS FORGIN PVTLTD21-Dec-2017 By RTGS ID:8112 [From,0,232684,-82974538.59,-82974538.59,0,232684,True,RTGS,39
21-12-2017,21-Dec-17,21-Dec-2017 By RTGS ID:8112 [From120313023790 NOVATECHPROJECTS (INDIA) PVT LTD 601,400000,0,-82574538.59,-82574538.59,400000,0,True,RTGS,39
21-12-2017,21-Dec-17,21-Dec-2017 To RTGS[ID:8113 For32343227367 NOVATECHPROJECTS I PVT LTD],0,1600000,-84174538.59,-84174538.59,0,1600000,True,RTGS,39
21-12-2017,21-Dec-17,21-Dec-2017 To Comm. on RTGS[ID:8113 For32343227367 NOVATECHPROJECTS I PVT LTD],0,64,-84174602.59,-84174602.59,0,64,True,RTGS,39
22-12-2017,22-Dec-17,22-Dec-2017 To RTGS[ID:8119 For4138002100012707 JEETENGINEERING],0,500000,-84674602.59,-84674602.59,0,500000,True,RTGS,39
22-12-2017,22-Dec-17,22-Dec-2017 To Comm. on RTGS[ID:8119 For4138002100012707 JEETENGINEERING],0,32,-84674634.59,-84674634.59,0,32,True,RTGS,39
22-12-2017,22-Dec-17,22-Dec-2017 UDAYAN SANGHA,0,2500,-84677134.59,-84677134.59,0,2500,True,Others,39
22-12-2017,22-Dec-17,22-Dec-2017 By NEFT ID:56914 [FromRAMAGUNDAM FERTILIZERSAND CHEMICAL],14750,0,-84662384.59,-84662384.59,14750,0,True,NEFT,39
22-12-2017,22-Dec-17,22-Dec-2017 By NEFT ID:56918 [From CGSTCEN EX THANE REFU]26-Dec-2017 To SI TL/B-LOAN/180,313941,0,-84348443.59,-84348443.59,313941,0,True,NEFT,39
26-12-2017,26-Dec-17,26-Dec-2017 To SI TL/B-LOAN/180,0,14500,-84362943.59,-84362943.59,0,14500,True,ECS,39
27-12-2017,27-Dec-17,27-Dec-2017 JOHN GALT INTERNATIONAL,0,400000,-84762943.59,-84762943.59,0,400000,True,Others,39
28-12-2017,28-Dec-17,28-Dec-2017 By RTGS ID:8139 [From9011125900 BHARAT HEAVYELECTRICALS LIMITED TR,1685230,0,-83077713.59,-83077713.59,1685230,0,True,RTGS,39
28-12-2017,28-Dec-17,28-Dec-2017 MARVEL TUBES INDUSTRIES,0,175261,-83252974.59,-83252974.59,0,175261,True,Others,39
28-12-2017,28-Dec-17,28-Dec-2017 J B ENGINEERINGCORPORATION29-Dec-2017 To NEFT/HDFC-CAPITAL FIRST,0,228225,-83481199.59,-83481199.59,0,228225,True,NEFT,39
29-12-2017,29-Dec-17,29-Dec-2017 To NEFT/HDFC-CAPITAL FIRSTL-004417363057304[ID:57304]29-Dec-2017 To Comm.on,0,250940,-83732139.59,-83732139.59,0,250940,True,NEFT,39
29-12-2017,29-Dec-17,29-Dec-2017 To Comm.onNEFT:/HDFC-CAPITAL FIRSTL-004417363057304[ID:57304],0,29,-83732168.59,-83732168.59,0,29,True,NEFT,39
29-12-2017,29-Dec-17,29-Dec-2017 To NEFT/IBKL-THE SVC COOPER-004417363057309[ID:57309],0,11550,-83743718.59,-83743718.59,0,11550,True,NEFT,39
29-12-2017,29-Dec-17,29-Dec-2017 To Comm.on NEFT:/IBKL-THESVC COOPER-004417363057309[ID:5730,0,6,-83743724.59,-83743724.59,0,6,True,NEFT,39
30-12-2017,30-Dec-17,30-Dec-2017 To Folio Chrgs01/10/2017-31/12/201730-Dec-2017 To NEFT/SBIN-NOVATECH,0,1425,-83745149.59,-83745149.59,0,1425,True,CHARGES,39
30-12-2017,30-Dec-17,30-Dec-2017 To NEFT/SBIN-NOVATECHPROJEC-004417364057375[ID:57375],0,100000,-83845149.59,-83845149.59,0,100000,True,NEFT,39
30-12-2017,30-Dec-17,30-Dec-2017 To Comm.onNEFT:/SBIN-NOVATECHPROJEC-004417364057375[ID:57,0,6,-83845155.59,-83845155.59,0,6,True,NEFT,39
30-12-2017,30-Dec-17,30-Dec-2017 To NEFT/IBKL-NOVATECHPROJEC-004417364057378[ID:57378],0,50000,-83895155.59,-83895155.59,0,50000,True,NEFT,39
30-12-2017,30-Dec-17,30-Dec-2017 To Comm.onNEFT:/IBKL-NOVATECHPROJEC-004417364057378[ID:57,0,6,-83895161.59,-83895161.59,0,6,True,NEFT,39
30-12-2017,30-Dec-17,30-Dec-2017 To NEFT/DEUT-DEUTSCHEBANKA-004417364057371[ID:57371],0,184163,-84079324.59,-84079324.59,0,184163,True,NEFT,39
30-12-2017,30-Dec-17,30-Dec-2017 To Comm.onNEFT:/DEUT-DEUTSCHE BANKA-004417364057371[ID:57371],0,16,-84079340.59,-84079340.59,0,16,True,NEFT,39
30-12-2017,30-Dec-17,30-Dec-2017 EXECUTIVE ENGG MIDC,0,3404,-84082744.59,-84082744.59,0,3404,True,Others,39
30-12-2017,30-Dec-17,30-Dec-2017 To Self,0,30000,-84112744.59,-84112744.59,0,30000,True,CASH,39
30-12-2017,30-Dec-17,30-Dec-2017 To NEFT- 13000/15000/10000,0,38000,-84150744.59,-84150744.59,0,38000,True,NEFT,39
30-12-2017,30-Dec-17,30-Dec-2017 To NEFT/UTIB-CHANDANSOUTIA-004417364057398[ID:57398],0,50000,-84200744.59,-84200744.59,0,50000,True,NEFT,39
30-12-2017,30-Dec-17,30-Dec-2017 To Comm.onNEFT:/UTIB-CHANDANSOUTIA-004417364057398[ID:57,0,6,-84200750.59,-84200750.59,0,6,True,NEFT,39
31-12-2017,31-Dec-17,31-Dec-2017 To Int. Dr. 01/12/2017,0,901834,-85102584.59,-85102584.59,0,901834,True,Others,39
01-01-2018,01-Jan-18,By Opening Balance,0,0,-85102584.59,-85102584.59,0,0,True,Others,39
01-01-2018,01-Jan-18,To ACH DR KMBLDRAOPE,0,146889,-85249473.59,-85249473.59,0,146889,True,NACH,39
01-01-2018,01-Jan-18,By RTGS ID:8169 [From120313023790 NOVATECHPROJECTS (INDIA) PVT LTD 601,400000,0,-84849473.59,-84849473.59,400000,0,True,RTGS,39
02-01-2018,02-Jan-18,By RTGS ID:8171 [From9011125900 BHARAT HEAVYELECTRICALS LIMITED TR,1671370,0,-83178103.59,-83178103.59,1671370,0,True,RTGS,39
02-01-2018,02-Jan-18,MTNL,0,620,-83178723.59,-83178723.59,0,620,True,Others,39
02-01-2018,02-Jan-18,By RTGS ID:8174 [From140310000725BERGERAUTOANDINDUSTRIAL,1307453,0,-81871270.59,-81871270.59,1307453,0,True,RTGS,39
03-01-2018,03-Jan-18,To ACH DR TP ACH TAT,0,244816,-82116086.59,-82116086.59,0,244816,True,NACH,39
04-01-2018,04-Jan-18,To NEFT/KKBK-SOUMADEEPSUKUM-004418004057678[ID:57678],0,41539,-82157625.59,-82157625.59,0,41539,True,NEFT,39
04-01-2018,04-Jan-18,To Comm.onNEFT:/KKBK-SOUMADEEPSUKUM-004418004057678[ID:57,0,6,-82157631.59,-82157631.59,0,6,True,NEFT,39
04-01-2018,04-Jan-18,To RTGS[ID:8176 For283111100000326 KIRAN SALESCORPORATION],0,500000,-82657631.59,-82657631.59,0,500000,True,RTGS,39
04-01-2018,04-Jan-18,To Comm. on RTGS[ID:8176 For283111100000326 KIRAN SALESCORPORATION],0,32,-82657663.59,-82657663.59,0,32,True,RTGS,39
04-01-2018,04-Jan-18,To NEFT/FDRL-TEJASENGINEERI-004418004057687[ID:57687],0,55772,-82713435.59,-82713435.59,0,55772,True,NEFT,39
04-01-2018,04-Jan-18,To Comm.on NEFT:/FDRL-TEJASENGINEERI-004418004057687[ID:57687],0,6,-82713441.59,-82713441.59,0,6,True,NEFT,39
04-01-2018,04-Jan-18,To NEFT/UTIB-VAIBHAVSHELKE-004418004057719[ID:57719],0,18000,-82731441.59,-82731441.59,0,18000,True,NEFT,39
04-01-2018,04-Jan-18,To Comm.onNEFT:/UTIB-VAIBHAVSHELKE-004418004057719[ID:57,0,6,-82731447.59,-82731447.59,0,6,True,NEFT,39
04-01-2018,04-Jan-18,By NEFT/HDFC-GARDENREACH SH-N004180446272302[ID:57732],4398838.2,0,-78332609.39,-78332609.39,4398838.2,0,True,NEFT,39
05-01-2018,05-Jan-18,To ACH DR BDACH-RTBN,0,98440,-78431049.39,-78431049.39,0,98440,True,NACH,39
05-01-2018,05-Jan-18,To ACH DR HDFC BANK,0,19408,-78450457.39,-78450457.39,0,19408,True,NACH,39
05-01-2018,05-Jan-18,To ACH DR IVL FINANC,0,179511,-78629968.39,-78629968.39,0,179511,True,NACH,39
05-01-2018,05-Jan-18,To ACH DR ADITY BIRL,0,203544,-78833512.39,-78833512.39,0,203544,True,NACH,39
05-01-2018,05-Jan-18,SUPREME HVAC,0,75000,-78908512.39,-78908512.39,0,75000,True,Others,39
06-01-2018,06-Jan-18,To LC-No 159 Retired,0,2460300,-81368812.39,-81368812.39,0,2460300,True,Others,39
06-01-2018,06-Jan-18,To Self,0,25000,-81393812.39,-81393812.39,0,25000,True,CASH,39
06-01-2018,06-Jan-18,To ROC FILING & SEARCHREPORT CHGS-DORVPROCESS EQIPMENT,0,2760,-81396572.39,-81396572.39,0,2760,True,CHARGES,39
06-01-2018,06-Jan-18,To ROC FILING & SEARCHREPORT CHGSTo LC-No 164 Retired,0,2960,-81399532.39,-81399532.39,0,2960,True,CHARGES,39
08-01-2018,08-Jan-18,To LC-No 164 Retired,0,2122641,-83522173.39,-83522173.39,0,2122641,True,Others,39
08-01-2018,08-Jan-18,To INT @ 9.5% FOR 90DAYS ONLC NO 164 BV STEEL CORTo ACH DR MAGMAFINCO,0,49722,-83571895.39,-83571895.39,0,49722,True,NACH,39
08-01-2018,08-Jan-18,To ACH DR MAGMAFINCO,0,121329,-83693224.39,-83693224.39,0,121329,True,NACH,39
08-01-2018,08-Jan-18,To ACH DR MAGMAFINCO,0,161578,-83854802.39,-83854802.39,0,161578,True,NACH,39
08-01-2018,08-Jan-18,To NEFT/BARB-AMANPETROLEUM-004418008057950[ID:57950],0,150000,-84004802.39,-84004802.39,0,150000,True,NEFT,39
08-01-2018,08-Jan-18,To Comm.on NEFT:/BARB-AMANPETROLEUM-004418008057950[ID:57950],0,16,-84004818.39,-84004818.39,0,16,True,NEFT,39
09-01-2018,09-Jan-18,To DECS HDFC BANK46239223A S ENGINEERS,0,11900,-84016718.39,-84016718.39,0,11900,True,ECS,39
09-01-2018,09-Jan-18,A S ENGINEERSFABRICATIONSTo Commission Charged on,0,300000,-84316718.39,-84316718.39,0,300000,True,CHARGES,39
09-01-2018,09-Jan-18,To Commission Charged onLC/No.188To Service Charges Charged on,0,8602,-84325320.39,-84325320.39,0,8602,True,CHARGES,39
09-01-2018,09-Jan-18,To Service Charges Charged onLC/No.188To SI TL/B-LOAN/149,0,1150,-84326470.39,-84326470.39,0,1150,True,CHARGES,39
11-01-2018,11-Jan-18,To SI TL/B-LOAN/149,0,101876,-84428346.39,-84428346.39,0,101876,True,ECS,39
11-01-2018,11-Jan-18,By NEFT/HSBC-DOWCHEMICALIN-HSBCN18010541707,3098200,0,-81330146.39,-81330146.39,3098200,0,True,NEFT,39
11-01-2018,11-Jan-18,To RTGS[ID:8205 For31445403913 GOLDYPROJECTS PVT LTD],0,200000,-81530146.39,-81530146.39,0,200000,True,RTGS,39
11-01-2018,11-Jan-18,To Comm. on RTGS[ID:8205 For31445403913 GOLDYPROJECTS PVT LTD],0,32,-81530178.39,-81530178.39,0,32,True,RTGS,39
11-01-2018,11-Jan-18,To RTGS[ID:8204 For08732120001884 SEVAGIRICONTRACTOR],0,200000,-81730178.39,-81730178.39,0,200000,True,RTGS,39
11-01-2018,11-Jan-18,To Comm. on RTGS[ID:8204 For08732120001884 SEVAGIRICONTRACTOR],0,32,-81730210.39,-81730210.39,0,32,True,RTGS,39
11-01-2018,11-Jan-18,To NEFT/HDFC-A BENGINEERING-004418011058158[ID:58158],0,150000,-81880210.39,-81880210.39,0,150000,True,NEFT,39
11-01-2018,11-Jan-18,To Comm.on NEFT:/HDFC-A BENGINEERING-004418011058158[ID:58158],0,16,-81880226.39,-81880226.39,0,16,True,NEFT,39
11-01-2018,11-Jan-18,To NEFT/SCBL-NOVATECHPROJEC-004418011058157[ID:58157],0,150000,-82030226.39,-82030226.39,0,150000,True,NEFT,39
11-01-2018,11-Jan-18,To Comm.onNEFT:/SCBL-NOVATECHPROJEC-004418011058157[ID:58,0,16,-82030242.39,-82030242.39,0,16,True,NEFT,39
11-01-2018,11-Jan-18,SAMBHAV ENTERPRISES,0,251549,-82281791.39,-82281791.39,0,251549,True,Others,39
11-01-2018,11-Jan-18,AIRTEL,0,21981,-82303772.39,-82303772.39,0,21981,True,Others,39
11-01-2018,11-Jan-18,VIKHYAT SERVICES,0,10520,-82314292.39,-82314292.39,0,10520,True,Others,39
11-01-2018,11-Jan-18,AANEE FACILITIES SERVICES,0,75600,-82389892.39,-82389892.39,0,75600,True,Others,39
11-01-2018,11-Jan-18,To NEFT/UTIB-AMOLLAD-004418011058180[ID:58180]To Comm.on NEFT:/UTIB-AMOL,0,4000,-82393892.39,-82393892.39,0,4000,True,NEFT,39
11-01-2018,11-Jan-18,To Comm.on NEFT:/UTIB-AMOLLAD-004418011058180[ID:58180]To Commission Charged on,0,3,-82393895.39,-82393895.39,0,3,True,CHARGES,39
11-01-2018,11-Jan-18,To Commission Charged onLC/No.189To Service Charges Charged on,0,61525,-82455420.39,-82455420.39,0,61525,True,CHARGES,39
11-01-2018,11-Jan-18,To Service Charges Charged onLC/No.189To PAY ORDER,0,1150,-82456570.39,-82456570.39,0,1150,True,CHARGES,39
12-01-2018,12-Jan-18,To PAY ORDER,0,233660,-82690230.39,-82690230.39,0,233660,True,Others,39
12-01-2018,12-Jan-18,To CHARGES ON PAYORDER,0,288,-82690518.39,-82690518.39,0,288,True,CHARGES,39
12-01-2018,12-Jan-18,To CHARGES ON PAYORDER,0,138,-82690656.39,-82690656.39,0,138,True,CHARGES,39
12-01-2018,12-Jan-18,To CHARGES ON PAYORDER,0,75,-82690731.39,-82690731.39,0,75,True,CHARGES,39
12-01-2018,12-Jan-18,To CHARGES ON PAYORDER,0,117,-82690848.39,-82690848.39,0,117,True,CHARGES,39
12-01-2018,12-Jan-18,To CHARGES ON PAYORDER,0,99,-82690947.39,-82690947.39,0,99,True,CHARGES,39
12-01-2018,12-Jan-18,P M SHAH V M SHAH,0,54594,-82745541.39,-82745541.39,0,54594,True,Others,39
12-01-2018,12-Jan-18,PEACEFORT CHEM IND ENGGP LTDTo NEFT/IBKL-THE SVC CO,0,569514,-83315055.39,-83315055.39,0,569514,True,NEFT,39
12-01-2018,12-Jan-18,To NEFT/IBKL-THE SVC COOPER-004418012058268[ID:58268],0,22141,-83337196.39,-83337196.39,0,22141,True,NEFT,39
12-01-2018,12-Jan-18,To Comm.on NEFT:/IBKL-THESVC COOPER-004418012058268[ID:5826,0,6,-83337202.39,-83337202.39,0,6,True,NEFT,39
12-01-2018,12-Jan-18,To NEFT/IBKL-THE SVC COOPER-004418012058267[ID:58267],0,63100,-83400302.39,-83400302.39,0,63100,True,NEFT,39
12-01-2018,12-Jan-18,To Comm.on NEFT:/IBKL-THESVC COOPER-004418012058267[ID:5826,0,6,-83400308.39,-83400308.39,0,6,True,NEFT,39
12-01-2018,12-Jan-18,To NEFT/IBKL-THE SVC COOPER-004418012058266[ID:58266],0,7636,-83407944.39,-83407944.39,0,7636,True,NEFT,39
12-01-2018,12-Jan-18,To Comm.on NEFT:/IBKL-THESVC COOPER-004418012058266[ID:5826,0,3,-83407947.39,-83407947.39,0,3,True,NEFT,39
12-01-2018,12-Jan-18,To NEFT/IBKL-THE SVC COOPER-004418012058275[ID:58275],0,160,-83408107.39,-83408107.39,0,160,True,NEFT,39
12-01-2018,12-Jan-18,To Comm.on NEFT:/IBKL-THESVC COOPER-004418012058275[ID:5827,0,3,-83408110.39,-83408110.39,0,3,True,NEFT,39
15-01-2018,15-Jan-18,To DECS TP-ICICI B1412531850By NEFT ID:58392 [From INDIAN,0,13680,-83421790.39,-83421790.39,0,13680,True,NEFT,39
15-01-2018,15-Jan-18,By NEFT ID:58392 [From INDIANOIL CORPORATION LTD]To DECS IILECSCN00053180,655427,0,-82766363.39,-82766363.39,655427,0,True,NEFT,39
16-01-2018,16-Jan-18,To DECS IILECSCN00053180,0,85227,-82851590.39,-82851590.39,0,85227,True,ECS,39
16-01-2018,16-Jan-18,To PO No. Issued.,0,32046,-82883636.39,-82883636.39,0,32046,True,Others,39
16-01-2018,16-Jan-18,By RTGS ID:8223 [From INHSBC 006-032379-002THYSSENKRUPP INDUSTRIAL,1767631,0,-81116005.39,-81116005.39,1767631,0,True,RTGS,39
16-01-2018,16-Jan-18,ROADLINES INDIA PVT LTD,0,53200,-81169205.39,-81169205.39,0,53200,True,Others,39
16-01-2018,16-Jan-18,TIME SQUARE LOGISTICS,0,191350,-81360555.39,-81360555.39,0,191350,True,Others,39
16-01-2018,16-Jan-18,ADI SHAKTI INDUSTRIES,0,150000,-81510555.39,-81510555.39,0,150000,True,Others,39
16-01-2018,16-Jan-18,VISHWAKARMA UDYOG,0,100000,-81610555.39,-81610555.39,0,100000,True,Others,39
16-01-2018,16-Jan-18,B M COATS,0,100000,-81710555.39,-81710555.39,0,100000,True,Others,39
16-01-2018,16-Jan-18,NIMBUS LOGISTICS,0,200000,-81910555.39,-81910555.39,0,200000,True,Others,39
16-01-2018,16-Jan-18,OFFSHORE TESTINGINSPECTIONAP CLEANING WORKS,0,64715,-81975270.39,-81975270.39,0,64715,True,Others,39
16-01-2018,16-Jan-18,AP CLEANING WORKS,0,200000,-82175270.39,-82175270.39,0,200000,True,Others,39
16-01-2018,16-Jan-18,To NEFT/SCBL-NOVATECHPROJEC-004418016058501[ID:58501],0,1000000,-83175270.39,-83175270.39,0,1000000,True,NEFT,39
16-01-2018,16-Jan-18,To Comm.onNEFT:/SCBL-NOVATECHPROJEC-004418016058501[ID:58,0,29,-83175299.39,-83175299.39,0,29,True,NEFT,39
16-01-2018,16-Jan-18,To NEFT/SCBL-NOVATECHPROJEC-004418016058502[ID:58502],0,200000,-83375299.39,-83375299.39,0,200000,True,NEFT,39
16-01-2018,16-Jan-18,To Comm.onNEFT:/SCBL-NOVATECHPROJEC-004418016058502[ID:58,0,16,-83375315.39,-83375315.39,0,16,True,NEFT,39
17-01-2018,17-Jan-18,CHEMBOND CHEMICALSLIMITEDRADIAGO WORK SOLUTIONS,0,143894,-83519209.39,-83519209.39,0,143894,True,Others,39
17-01-2018,17-Jan-18,RADIAGO WORK SOLUTIONS,0,54998,-83574207.39,-83574207.39,0,54998,True,Others,39
18-01-2018,18-Jan-18,To FRANKING CHGS FRINDEMNITY DOCUS OF LCENHANCEM,0,100000,-83674207.39,-83674207.39,0,100000,True,CHARGES,39
18-01-2018,18-Jan-18,METICULOUS SERVICES,0,3297,-83677504.39,-83677504.39,0,3297,True,Others,39
18-01-2018,18-Jan-18,To Service Charges Charged onLC/No.191To Service Charges Charged on,0,1150,-83678654.39,-83678654.39,0,1150,True,CHARGES,39
18-01-2018,18-Jan-18,To Service Charges Charged onLC/No.192To LC-No 161 Retired,0,1150,-83679804.39,-83679804.39,0,1150,True,CHARGES,39
18-01-2018,18-Jan-18,To LC-No 161 Retired,0,1668515,-85348319.39,-85348319.39,0,1668515,True,Others,39
18-01-2018,18-Jan-18,By NEFT ID:58679 [FromNOVATECH PROJECTS (INDIA)PVT LTD],500000,0,-84848319.39,-84848319.39,500000,0,True,NEFT,39
19-01-2018,19-Jan-18,J B ENGINEERINGCORPORATIONMAYUR TYRES,0,252362,-85100681.39,-85100681.39,0,252362,True,Others,39
19-01-2018,19-Jan-18,MAYUR TYRES,0,46000,-85146681.39,-85146681.39,0,46000,True,Others,39
19-01-2018,19-Jan-18,JOHN GALT INTERNATIONAL,0,400000,-85546681.39,-85546681.39,0,400000,True,Others,39
20-01-2018,20-Jan-18,By RTGS ID:8241 [From9011125900 BHARAT HEAVYELECTRICALS LIMITED TR,1634737,0,-83911944.39,-83911944.39,1634737,0,True,RTGS,39
22-01-2018,22-Jan-18,To RTGS[ID:8243 For4138002100012707 JEETENGINEERING],0,600000,-84511944.39,-84511944.39,0,600000,True,RTGS,39
22-01-2018,22-Jan-18,To Comm. on RTGS[ID:8243 For4138002100012707 JEETENGINEERING],0,60,-84512004.39,-84512004.39,0,60,True,RTGS,39
22-01-2018,22-Jan-18,INTERTECH FITTINGS INDIA,0,45430,-84557434.39,-84557434.39,0,45430,True,Others,39
23-01-2018,23-Jan-18,By NEFT/SBIN-BGR ENERGYSYST-SBIN118023025029[ID:58956],3118040,0,-81439394.39,-81439394.39,3118040,0,True,NEFT,39
24-01-2018,24-Jan-18,To Self,0,25000,-81464394.39,-81464394.39,0,25000,True,CASH,39
24-01-2018,24-Jan-18,MTNL,0,4215,-81468609.39,-81468609.39,0,4215,True,Others,39
24-01-2018,24-Jan-18,SHIVOM ENTERPRISES,0,47023,-81515632.39,-81515632.39,0,47023,True,Others,39
24-01-2018,24-Jan-18,GENERAL TECHNOLOGIES,0,31270,-81546902.39,-81546902.39,0,31270,True,Others,39
24-01-2018,24-Jan-18,To Commission Charged onLC/No.193To Service Charges Charged on,0,15900,-81562802.39,-81562802.39,0,15900,True,CHARGES,39
24-01-2018,24-Jan-18,To Service Charges Charged onLC/No.193To NEFT/HDFC-ACC,0,1180,-81563982.39,-81563982.39,0,1180,True,CHARGES,39
24-01-2018,24-Jan-18,To NEFT/HDFC-ACCLTD-004418024059007[ID:59007]To Comm.on NEFT:/HDFC-ACC,0,631100,-82195082.39,-82195082.39,0,631100,True,NEFT,39
24-01-2018,24-Jan-18,To Comm.on NEFT:/HDFC-ACCLTD-004418024059007[ID:59007]ELCA LABORATORIES,0,29,-82195111.39,-82195111.39,0,29,True,NEFT,39
25-01-2018,25-Jan-18,ELCA LABORATORIES,0,85377,-82280488.39,-82280488.39,0,85377,True,Others,39
25-01-2018,25-Jan-18,To LC-No 167 Retired,0,2302002,-84582490.39,-84582490.39,0,2302002,True,Others,39
25-01-2018,25-Jan-18,By RTGS ID:8260 From120313023790NOVATECHPROJECTS (INDIA) PVT LTD601,4500000,0,-80082490.39,-80082490.39,4500000,0,True,RTGS,39
25-01-2018,25-Jan-18,,0,3222,-80085712.39,-80085712.39,0,3222,True,Others,39
29-01-2018,29-Jan-18,To SI TL/B-LOAN/180,0,14500,-80100212.39,-80100212.39,0,14500,True,ECS,39
29-01-2018,29-Jan-18,NEW AJMER TRAILORSERVICETo PROC CHGS FOR,0,240000,-80340212.39,-80340212.39,0,240000,True,CHARGES,39
29-01-2018,29-Jan-18,To PROC CHGS FORENHANCEMENT & RENEWALOF LIMIT,0,1124540,-81464752.39,-81464752.39,0,1124540,True,CHARGES,39
29-01-2018,29-Jan-18,By NEFT/SBIN-RAMAGUNDAMFERT-SBIN318029630155[ID:59175],2559000,0,-78905752.39,-78905752.39,2559000,0,True,NEFT,39
30-01-2018,30-Jan-18,To RTGS[ID:8284 For901102000026594OUTOKUMPU INDIA PVT LTD],0,4907468,-83813220.39,-83813220.39,0,4907468,True,RTGS,39
30-01-2018,30-Jan-18,To Comm. on RTGS[ID:8284 For901102000026594OUTOKUMPU INDIA PVT LTD],0,60,-83813280.39,-83813280.39,0,60,True,RTGS,39
30-01-2018,30-Jan-18,OM LIFTERS,0,122760,-83936040.39,-83936040.39,0,122760,True,Others,39
30-01-2018,30-Jan-18,OM SAI ELECTRIC WORKS,0,47122,-83983162.39,-83983162.39,0,47122,True,Others,39
30-01-2018,30-Jan-18,BALSONA INDUSTRIAL PAINTS,0,141468,-84124630.39,-84124630.39,0,141468,True,Others,39
30-01-2018,30-Jan-18,MANIBHADRA TUBECORPORATIONHARI OM ELECTRIC WORKS,0,91555,-84216185.39,-84216185.39,0,91555,True,Others,39
30-01-2018,30-Jan-18,HARI OM ELECTRIC WORKS,0,26379,-84242564.39,-84242564.39,0,26379,True,Others,39
30-01-2018,30-Jan-18,S R FABRICATOR,0,39652,-84282216.39,-84282216.39,0,39652,True,Others,39
30-01-2018,30-Jan-18,To Commission Charged onLC/No.194To Service Charges Charged on,0,76127,-84358343.39,-84358343.39,0,76127,True,CHARGES,39
30-01-2018,30-Jan-18,To Service Charges Charged onLC/No.194To NEFT/BKDN-RAJU,0,1180,-84359523.39,-84359523.39,0,1180,True,CHARGES,39
30-01-2018,30-Jan-18,To NEFT/BKDN-RAJUD-004418030059250[ID:59250]30-Jan-2018 To Comm.on NEFT:/BKDN-RAJU,0,45000,-84404523.39,-84404523.39,0,45000,True,NEFT,39
30-01-2018,30-Jan-18,30-Jan-2018 To Comm.on NEFT:/BKDN-RAJUD-004418030059250[ID:59250]30-Jan-2018 To NEFT/HDFC-ADITYA,0,6,-84404529.39,-84404529.39,0,6,True,NEFT,39
30-01-2018,30-Jan-18,30-Jan-2018 To NEFT/HDFC-ADITYAENGINEER-004418030059257[ID:59257],0,75000,-84479529.39,-84479529.39,0,75000,True,NEFT,39
30-01-2018,30-Jan-18,30-Jan-2018 To Comm.onNEFT:/HDFC-ADITYAENGINEER-004418030059257[ID:,0,6,-84479535.39,-84479535.39,0,6,True,NEFT,39
30-01-2018,30-Jan-18,30-Jan-2018 To NEFT/BARB-SHREE DURGACRA-004418030059256[ID:59256]30-Jan-2018 To Comm.on,0,100000,-84579535.39,-84579535.39,0,100000,True,NEFT,39
30-01-2018,30-Jan-18,30-Jan-2018 To Comm.onNEFT:/BARB-SHREE DURGACRA-004418030059256[ID:59256],0,6,-84579541.39,-84579541.39,0,6,True,NEFT,39
30-01-2018,30-Jan-18,30-Jan-2018 To NEFT/UTIB-AKSHAYMEHRA-004418030059263[ID:59263],0,5000,-84584541.39,-84584541.39,0,5000,True,NEFT,39
30-01-2018,30-Jan-18,30-Jan-2018 To Comm.onNEFT:/UTIB-AKSHAYMEHRA-004418030059263[ID:59,0,3,-84584544.39,-84584544.39,0,3,True,NEFT,39
30-01-2018,30-Jan-18,30-Jan-2018 To NEFT/KKBK-SEVAGIRICONTRA-004418030059262[ID:59262],0,300000,-84884544.39,-84884544.39,0,300000,True,NEFT,39
30-01-2018,30-Jan-18,30-Jan-2018 To Comm.onNEFT:/KKBK-SEVAGIRICONTRA-004418030059262[ID:59,0,29,-84884573.39,-84884573.39,0,29,True,NEFT,39
30-01-2018,30-Jan-18,30-Jan-2018 To NEFT/IBKL-THE SVC COOPER-004418030059259[ID:59259],0,11000,-84895573.39,-84895573.39,0,11000,True,NEFT,39
30-01-2018,30-Jan-18,30-Jan-2018 To Comm.on NEFT:/IBKL-THESVC COOPER-004418030059259[ID:5925,0,6,-84895579.39,-84895579.39,0,6,True,NEFT,39
31-01-2018,31-Jan-18,31-Jan-2018 by o/w-23/12-U K PAINTS (INDIA)PVT. LIMITED31-Jan-2018 SOHM ANALYTICAL SERVICES,1544544,0,-83351035.39,-83351035.39,1544544,0,True,OUTWARD,39
31-01-2018,31-Jan-18,31-Jan-2018 SOHM ANALYTICAL SERVICES,0,131108,-83482143.39,-83482143.39,0,131108,True,Others,39
31-01-2018,31-Jan-18,31-Jan-2018 By RTGS ID:8316 [From120313023790 NOVATECHPROJECTS (INDIA) PVT LTD 601,500000,0,-82982143.39,-82982143.39,500000,0,True,RTGS,39
31-01-2018,31-Jan-18,31-Jan-2018 To Commission Charged onLC/No.19531-Jan-2018 To TD/FDL/11516,0,13703,-82995846.39,-82995846.39,0,13703,True,CHARGES,39
31-01-2018,31-Jan-18,31-Jan-2018 To TD/FDL/11516,0,1000000,-83995846.39,-83995846.39,0,1000000,True,Others,39
31-01-2018,31-Jan-18,31-Jan-2018 To Int. Dr. 01/01/2018-0.015361744301288401-Feb-2018 To ACH DR KMBLDRAOPE,0,903984,-84899830.39,-84899830.39,0,903984,True,NACH,39
01-02-2018,1-Feb-18,01-Feb-2018 To ACH DR KMBLDRAOPE,0,146889,-85046719.39,-85046719.39,0,146889,True,NACH,39
01-02-2018,1-Feb-18,01-Feb-2018 DIVY ROLLFORM LIMITED,0,294528,-85341247.39,-85341247.39,0,294528,True,Others,39
01-02-2018,1-Feb-18,01-Feb-2018 MESSIAH AIR COOL SERVICECENTREDate Particulars,0,5310,-85346557.39,-85346557.39,0,5310,True,Others,39
01-02-2018,1-Feb-18,01-Feb-2018 By NEFT ID:59468 [FromNOVATECH PROJECTS (INDIA)PVT LTD],250000,0,-85096557.39,-85096557.39,250000,0,True,NEFT,39
02-02-2018,2-Feb-18,02-Feb-2018 UNITED SECURITY FORCE,0,116245,-85212802.39,-85212802.39,0,116245,True,Others,39
02-02-2018,2-Feb-18,02-Feb-2018 SAI SAGAR ENTERPRISES,0,201960,-85414762.39,-85414762.39,0,201960,True,Others,39
03-02-2018,3-Feb-18,03-Feb-2018 To ACH DR TP ACH TAT,0,244816,-85659578.39,-85659578.39,0,244816,True,NACH,39
03-02-2018,3-Feb-18,03-Feb-2018 By RTGS ID:8357 [From120313023790 NOVATECHPROJECTS (INDIA) PVT LTD 601,500000,0,-85159578.39,-85159578.39,500000,0,True,RTGS,39
03-02-2018,3-Feb-18,03-Feb-2018 To NEFT/PUNB-ASHIRWADENTERP-004418034059630[ID:59630],0,69209,-85228787.39,-85228787.39,0,69209,True,NEFT,39
03-02-2018,3-Feb-18,03-Feb-2018 To Comm.onNEFT:/PUNB-ASHIRWADENTERP-004418034059630[ID:59,0,6,-85228793.39,-85228793.39,0,6,True,NEFT,39
05-02-2018,5-Feb-18,05-Feb-2018 By RTGS ID:8367 From004102000029333SIMPLEXCASTINGS LTD32 SHIVNATH,9689072,0,-75539721.39,-75539721.39,9689072,0,True,RTGS,39
05-02-2018,5-Feb-18,05-Feb-2018 To LC-No 163 Retired,0,2419236,-77958957.39,-77958957.39,0,2419236,True,Others,39
05-02-2018,5-Feb-18,05-Feb-2018 To INT @ 9.5% FOR 90 DAYSON LC NO 16305-Feb-2018 To ACH DR ADITY BIRL,0,56670,-78015627.39,-78015627.39,0,56670,True,NACH,39
05-02-2018,5-Feb-18,05-Feb-2018 To ACH DR ADITY BIRL,0,203544,-78219171.39,-78219171.39,0,203544,True,NACH,39
05-02-2018,5-Feb-18,05-Feb-2018 OMKAR CANTEEN,0,200000,-78419171.39,-78419171.39,0,200000,True,Others,39
05-02-2018,5-Feb-18,05-Feb-2018 SIDDHANATH TRAVELS,0,18500,-78437671.39,-78437671.39,0,18500,True,Others,39
05-02-2018,5-Feb-18,05-Feb-2018 RUSHABH FASTNERS,0,32052,-78469723.39,-78469723.39,0,32052,True,Others,39
05-02-2018,5-Feb-18,05-Feb-2018 To ACH DR IVL FINANC,0,179511,-78649234.39,-78649234.39,0,179511,True,NACH,39
05-02-2018,5-Feb-18,05-Feb-2018 To Commission Charged onLC/No.19605-Feb-2018 To Service Charges Charged on,0,90273,-78739507.39,-78739507.39,0,90273,True,CHARGES,39
05-02-2018,5-Feb-18,05-Feb-2018 To Service Charges Charged onLC/No.19605-Feb-2018 To TD/FDL/11525,0,1180,-78740687.39,-78740687.39,0,1180,True,CHARGES,39
05-02-2018,5-Feb-18,05-Feb-2018 To TD/FDL/11525,0,1000000,-79740687.39,-79740687.39,0,1000000,True,Others,39
05-02-2018,5-Feb-18,05-Feb-2018 To NEFT/IBKL-MAA TARADEVIBU-004418036059723[ID:59723]05-Feb-2018 To Comm.on NEFT:/IBKL-MAA,0,65371,-79806058.39,-79806058.39,0,65371,True,NEFT,39
05-02-2018,5-Feb-18,05-Feb-2018 To Comm.on NEFT:/IBKL-MAATARADEVIBU-004418036059723[ID:59723],0,6,-79806064.39,-79806064.39,0,6,True,NEFT,39
05-02-2018,5-Feb-18,05-Feb-2018 To SHORT COMM ON LCRECOVERED06-Feb-2018 by o/w-17/16-YADAV STEEL,0,7352,-79813416.39,-79813416.39,0,7352,True,OUTWARD,39
06-02-2018,6-Feb-18,06-Feb-2018 by o/w-17/16-YADAV STEEL,226265,0,-79587151.39,-79587151.39,226265,0,True,OUTWARD,39
06-02-2018,6-Feb-18,06-Feb-2018 By RTGS ID:8375 [From140310000725BERGERAUTOANDINDUSTRIAL,1121571,0,-78465580.39,-78465580.39,1121571,0,True,RTGS,39
06-02-2018,6-Feb-18,06-Feb-2018 To INT ON LC NO 163,0,7632,-78473212.39,-78473212.39,0,7632,True,Others,39
06-02-2018,6-Feb-18,06-Feb-2018 To INT ON LC NO 163 PD TO JDSTEEL07-Feb-2018 By REVERSAL OF WRONG,0,762,-78473974.39,-78473974.39,0,762,True,Others,39
07-02-2018,7-Feb-18,07-Feb-2018 By REVERSAL OF WRONGENTRY DTD 06.02.201807-Feb-2018 To ACH DR HDFC BANK,7632,0,-78466342.39,-78466342.39,7632,0,True,NACH,39
07-02-2018,7-Feb-18,07-Feb-2018 To ACH DR HDFC BANK,0,19408,-78485750.39,-78485750.39,0,19408,True,NACH,39
07-02-2018,7-Feb-18,07-Feb-2018 To ACH DR MAGMAFINCO,0,161578,-78647328.39,-78647328.39,0,161578,True,NACH,39
07-02-2018,7-Feb-18,07-Feb-2018 To ACH DR MAGMAFINCO,0,121329,-78768657.39,-78768657.39,0,121329,True,NACH,39
07-02-2018,7-Feb-18,07-Feb-2018 To Commission Charged onLC/No.19707-Feb-2018 To Service Charges Charged on,0,89830,-78858487.39,-78858487.39,0,89830,True,CHARGES,39
07-02-2018,7-Feb-18,07-Feb-2018 To Service Charges Charged onLC/No.19707-Feb-2018 To TD/FDL/11528,0,1180,-78859667.39,-78859667.39,0,1180,True,CHARGES,39
07-02-2018,7-Feb-18,07-Feb-2018 To TD/FDL/11528,0,1000000,-79859667.39,-79859667.39,0,1000000,True,Others,39
07-02-2018,7-Feb-18,07-Feb-2018 To SHORT GST AMT ON LC-GEELTD DTD. 24.01.201708-Feb-2018 To LC-No 166 Retired,0,2864,-79862531.39,-79862531.39,0,2864,True,Others,39
08-02-2018,8-Feb-18,08-Feb-2018 To LC-No 166 Retired,0,8000506,-87863037.39,-87863037.39,0,8000506,True,Others,39
08-02-2018,8-Feb-18,08-Feb-2018 Recovery of NPCI DECS BounceChgs : HDFC BANK0000046239223 Dt: 08 Feb 2018,0,125,-87863162.39,-87863162.39,0,125,True,CHARGES,39
08-02-2018,8-Feb-18,08-Feb-2018 To I/W Bouncing Charges : 26799,0,450,-87863612.39,-87863612.39,0,450,True,CHARGES,39
08-02-2018,8-Feb-18,08-Feb-2018 To I/W Bouncing Charges : 26737,0,300,-87863912.39,-87863912.39,0,300,True,CHARGES,39
09-02-2018,9-Feb-18,09-Feb-2018 By RTGS ID:8401 From00441300002264U K PAINTSINDIA PVT. LIMITED19 DDA,4635120,0,-83228792.39,-83228792.39,4635120,0,True,RTGS,39
15-02-2018,15-Feb-18,15-Feb-2018 By NEFT/HDFC-GARDENREACH SH-N046180476075767[ID:60481],4491935.85,0,-78736856.54,-78736856.54,4491935.84999999,0,True,NEFT,39
16-02-2018,16-Feb-18,16-Feb-2018 By RTGS ID:8445 [From0129655100002318 BGRENERGY SYSTEMS LTD 443,540312,0,-78196544.54,-78196544.54,540312,0,True,RTGS,39
19-02-2018,19-Feb-18,19-Feb-2018 By RTGS ID:8457 From35912958425BGR ENERGYSYSTEMS LIMITED443 ANNA,3625132,0,-74571412.54,-74571412.54,3625132,0,True,RTGS,39
20-02-2018,20-Feb-18,20-Feb-2018 To LC-No 168 Retired,0,2003380,-76574792.54,-76574792.54,0,2003380,True,Others,39
20-02-2018,20-Feb-18,20-Feb-2018 By NEFT ID:60757 [From BGRENERGY SYSTEMS LIMITED]23-Feb-2018 By Transfer TD/FDS/2920,558185,0,-76016607.54,-76016607.54,558185,0,True,NEFT,39
23-02-2018,23-Feb-18,23-Feb-2018 By Transfer TD/FDS/2920,6634775,0,-69381832.54,-69381832.54,6634775,0,True,Others,39
23-02-2018,23-Feb-18,23-Feb-2018 By Transfer TD/FDS/2919,2403145,0,-66978687.54,-66978687.54,2403145.00000001,0,True,Others,39
28-02-2018,28-Feb-18,28-Feb-2018 To Int. Dr. 01/02/2018,0,763072,-67741759.54,-67741759.54,0,763072.000000008,True,Others,39
03-03-2018,03-Mar-18,03-Mar-2018 By Opening Balance,0,0,-67741759.54,-67741759.54,0,0,True,Others,39
03-03-2018,03-Mar-18,03-Mar-2018 To LC-No 175 Retired,0,1787582,-69529341.54,-69529341.54,0,1787582,True,Others,39
03-03-2018,03-Mar-18,03-Mar-2018 To INTEREST @ 9% FOR 90DAYS FOR LC PAYMENT07-Mar-2018 To LC-No 171 Retired,0,39670,-69569011.54,-69569011.54,0,39670,True,Others,39
07-03-2018,07-Mar-18,07-Mar-2018 To LC-No 171 Retired,0,2000000,-71569011.54,-71569011.54,0,2000000,True,Others,39
07-03-2018,07-Mar-18,07-Mar-2018 By MrgRev.GEN(BD)7/1142/HundiNo.BHEL/045,223936,0,-71345075.54,-71345075.54,223936,0,True,Others,39
07-03-2018,07-Mar-18,07-Mar-2018 To Hundi No (BHEL/045),0,84731,-71429806.54,-71429806.54,0,84731,True,Others,39
07-03-2018,07-Mar-18,07-Mar-2018 By MrgRev.GEN(BD)7/1143/HundiNo.BHEL/046,232707.6,0,-71197098.94,-71197098.94,232707.600000009,0,True,Others,39
07-03-2018,07-Mar-18,07-Mar-2018 To Hundi No (BHEL/046),0,88050,-71285148.94,-71285148.94,0,88050,True,Others,39
07-03-2018,07-Mar-18,07-Mar-2018 To Service Charges Charged onLC/No.19909-Mar-2018 by o/w-211/2-DEEPAK,0,1150,-71286298.94,-71286298.94,0,1150,True,CHARGES,39
09-03-2018,09-Mar-18,09-Mar-2018 by o/w-211/2-DEEPAKPHENOLICS LIMITED09-Mar-2018 By Mrg,439350,0,-70846948.94,-70846948.94,439350,0,True,OUTWARD,39
09-03-2018,09-Mar-18,09-Mar-2018 By MrgRev.GEN(BD)7/1144/HundiNo.BHEL/047,234825.1,0,-70612123.84,-70612123.84,234825.099999994,0,True,Others,39
09-03-2018,09-Mar-18,09-Mar-2018 To Hundi No (BHEL/047),0,90646,-70702769.84,-70702769.84,0,90646,True,Others,39
09-03-2018,09-Mar-18,09-Mar-2018 By MrgRev.GEN(BD)7/1150/HundiNo.BER/010,172595.2,0,-70530174.64,-70530174.64,172595.200000003,0,True,Others,39
09-03-2018,09-Mar-18,09-Mar-2018 To Hundi No (BER/010),0,65964,-70596138.64,-70596138.64,0,65964,True,Others,39
09-03-2018,09-Mar-18,09-Mar-2018 By MrgRev.GEN(BD)7/1148/HundiNo.BER/011,112622.5,0,-70483516.14,-70483516.14,112622.5,0,True,Others,39
09-03-2018,09-Mar-18,09-Mar-2018 To Hundi No (BER/011),0,41322,-70524838.14,-70524838.14,0,41322,True,Others,39
09-03-2018,09-Mar-18,09-Mar-2018 By MrgRev.GEN(BD)7/1159/HundiNo.BER/TAL/12,407756.8,0,-70117081.34,-70117081.34,407756.799999997,0,True,Others,39
09-03-2018,09-Mar-18,09-Mar-2018 To Hundi No (BER/TAL/12)Date Particulars09-Mar-2018 To LC-No 165 Retired,0,146491,-70263572.34,-70263572.34,0,146491,True,Others,39
09-03-2018,09-Mar-18,09-Mar-2018 To LC-No 165 Retired,0,2908700,-73172272.34,-73172272.34,0,2908700,True,Others,39
09-03-2018,09-Mar-18,09-Mar-2018 To INT @ 9.5% FOR 90 DAYSON LC 165 JD STEEL09-Mar-2018 By Disc. GEN(BD)7/Hundi,0,68135,-73240407.34,-73240407.34,0,68135,True,Others,39
09-03-2018,09-Mar-18,09-Mar-2018 By Disc. GEN(BD)7/HundiNo.BHEL/11209-Mar-2018 To Disc. GEN(BD)7/Hundi,677580.3,0,-72562827.04,-72562827.04,677580.299999997,0,True,Others,39
09-03-2018,09-Mar-18,09-Mar-2018 To Disc. GEN(BD)7/HundiNo.BHEL/11209-Mar-2018 By Disc. GEN(BD)7/Hundi,0,7147,-72569974.04,-72569974.04,0,7147,True,Others,39
09-03-2018,09-Mar-18,09-Mar-2018 By Disc. GEN(BD)7/HundiNo.BHEL/11309-Mar-2018 To Disc. GEN(BD)7/Hundi,793683.9,0,-71776290.14,-71776290.14,793683.900000006,0,True,Others,39
09-03-2018,09-Mar-18,09-Mar-2018 To Disc. GEN(BD)7/HundiNo.BHEL/11309-Mar-2018 By Disc. GEN(BD)7/Hundi,0,8372,-71784662.14,-71784662.14,0,8372,True,Others,39
09-03-2018,09-Mar-18,09-Mar-2018 By Disc. GEN(BD)7/HundiNo.BHEL/11609-Mar-2018 To Disc. GEN(BD)7/Hundi,461324.7,0,-71323337.44,-71323337.44,461324.700000003,0,True,Others,39
09-03-2018,09-Mar-18,09-Mar-2018 To Disc. GEN(BD)7/HundiNo.BHEL/11609-Mar-2018 By Disc. GEN(BD)7/Hundi,0,5978,-71329315.44,-71329315.44,0,5978,True,Others,39
09-03-2018,09-Mar-18,09-Mar-2018 By Disc. GEN(BD)7/HundiNo.BHEL/11709-Mar-2018 To Disc. GEN(BD)7/Hundi,887233.5,0,-70442081.94,-70442081.94,887233.5,0,True,Others,39
09-03-2018,09-Mar-18,09-Mar-2018 To Disc. GEN(BD)7/HundiNo.BHEL/11709-Mar-2018 By Disc. GEN(BD)7/Hundi,0,11498,-70453579.94,-70453579.94,0,11498,True,Others,39
09-03-2018,09-Mar-18,09-Mar-2018 By Disc. GEN(BD)7/HundiNo.BERGER/TAL/2909-Mar-2018 To Disc. GEN(BD)7/Hundi,7229353.5,0,-63224226.44,-63224226.44,7229353.5,0,True,Others,39
09-03-2018,09-Mar-18,09-Mar-2018 To Disc. GEN(BD)7/HundiNo.BERGER/TAL/2909-Mar-2018 By Disc. GEN(BD)7/Hundi,0,161224,-63385450.44,-63385450.44,0,161224,True,Others,39
09-03-2018,09-Mar-18,09-Mar-2018 By Disc. GEN(BD)7/HundiNo.BERGER/TAL/02509-Mar-2018 To Disc. GEN(BD)7/Hundi,1518915.6,0,-61866534.84,-61866534.84,1518915.59999999,0,True,Others,39
09-03-2018,09-Mar-18,09-Mar-2018 To Disc. GEN(BD)7/HundiNo.BERGER/TAL/02509-Mar-2018 To Commission Charged on,0,25634,-61892168.84,-61892168.84,0,25634,True,CHARGES,39
09-03-2018,09-Mar-18,09-Mar-2018 To Commission Charged onLC/No.20609-Mar-2018 To Service Charges Charged on,0,16131,-61908299.84,-61908299.84,0,16131,True,CHARGES,39
09-03-2018,09-Mar-18,09-Mar-2018 To Service Charges Charged onLC/No.20609-Mar-2018 To ROC CHGS FR,0,1180,-61909479.84,-61909479.84,0,1180,True,CHARGES,39
09-03-2018,09-Mar-18,09-Mar-2018 To ROC CHGS FRENHANCEMENT OF LC LIMIT09-Mar-2018 To Commission Charged on,0,2960,-61912439.84,-61912439.84,0,2960,True,CHARGES,39
09-03-2018,09-Mar-18,09-Mar-2018 To Commission Charged onLC/No.20709-Mar-2018 To Service Charges Charged on,0,90270,-62002709.84,-62002709.84,0,90270,True,CHARGES,39
09-03-2018,09-Mar-18,09-Mar-2018 To Service Charges Charged onLC/No.20709-Mar-2018 To Commission Charged on,0,1180,-62003889.84,-62003889.84,0,1180,True,CHARGES,39
09-03-2018,09-Mar-18,09-Mar-2018 To Commission Charged onLC/No.20809-Mar-2018 To Service Charges Charged on,0,91155,-62095044.84,-62095044.84,0,91155,True,CHARGES,39
09-03-2018,09-Mar-18,09-Mar-2018 To Service Charges Charged onLC/No.20809-Mar-2018 To TD/FDL/11553 LC MARGIN,0,1180,-62096224.84,-62096224.84,0,1180,True,CHARGES,39
09-03-2018,09-Mar-18,09-Mar-2018 To TD/FDL/11553 LC MARGIN,0,1000000,-63096224.84,-63096224.84,0,1000000,True,Others,39
09-03-2018,09-Mar-18,09-Mar-2018 To SI TL/B-LOAN/149,0,101876,-63198100.84,-63198100.84,0,101876,True,ECS,39
09-03-2018,09-Mar-18,09-Mar-2018 To SI TL/B-LOAN/180,0,14500,-63212600.84,-63212600.84,0,14500,True,ECS,39
12-03-2018,12-Mar-18,12-Mar-2018 To SI TL/B-LOAN/149,0,101876,-63314476.84,-63314476.84,0,101876,True,ECS,39
12-03-2018,12-Mar-18,12-Mar-2018 By RTGS ID:8593 [From9011125900 BHARAT HEAVYELECTRICALS LIMITED TR,512582,0,-62801894.84,-62801894.84,512582,0,True,RTGS,39
12-03-2018,12-Mar-18,12-Mar-2018 To NEFT/HDFC-TATA CAPITALFI-004418071062045[ID:62045]12-Mar-2018 To Comm.on NEFT:/HDFC-TATA,0,185000,-62986894.84,-62986894.84,0,185000,True,NEFT RETURN,39
12-03-2018,12-Mar-18,12-Mar-2018 To Comm.on NEFT:/HDFC-TATACAPITALFI-004418071062045[ID:62045],0,16,-62986910.84,-62986910.84,0,16,True,NEFT,39
12-03-2018,12-Mar-18,12-Mar-2018 To REALISATION OF BILLS,0,512582,-63499492.84,-63499492.84,0,512582,True,Others,39
12-03-2018,12-Mar-18,12-Mar-2018 By MrgRev.GEN(BD)7/1158/HundiNo.BER/TAL/003,154878.7,0,-63344614.14,-63344614.14,154878.700000003,0,True,Others,39
12-03-2018,12-Mar-18,12-Mar-2018 To Hundi No (BER/TAL/003),0,56234,-63400848.14,-63400848.14,0,56234,True,Others,39
12-03-2018,12-Mar-18,12-Mar-2018 By MrgRev.GEN(BD)7/1162/HundiNo.ber/tal/0014,407756.8,0,-62993091.34,-62993091.34,407756.799999997,0,True,Others,39
12-03-2018,12-Mar-18,12-Mar-2018 To Hundi No (ber/tal/0014),0,148049,-63141140.34,-63141140.34,0,148049,True,Others,39
12-03-2018,12-Mar-18,12-Mar-2018 By NEFT RETURN,185000,0,-62956140.34,-62956140.34,185000,0,True,NEFT RETURN,39
12-03-2018,12-Mar-18,12-Mar-2018 To NEFT/HDFC-ACCLTD-004418071062126[ID:62126]12-Mar-2018 To Comm.on NEFT:/HDFC-ACC,0,337500,-63293640.34,-63293640.34,0,337500,True,NEFT,39
12-03-2018,12-Mar-18,12-Mar-2018 To Comm.on NEFT:/HDFC-ACCLTD-004418071062126[ID:62126]12-Mar-2018 To NEFT/SBIN-NOVATECH,0,29,-63293669.34,-63293669.34,0,29,True,NEFT,39
12-03-2018,12-Mar-18,12-Mar-2018 To NEFT/SBIN-NOVATECHPROJEC-004418071062125[ID:62125],0,500000,-63793669.34,-63793669.34,0,500000,True,NEFT,39
12-03-2018,12-Mar-18,12-Mar-2018 To Comm.onNEFT:/SBIN-NOVATECHPROJEC-004418071062125[ID:62,0,29,-63793698.34,-63793698.34,0,29,True,NEFT,39
12-03-2018,12-Mar-18,12-Mar-2018 To NEFT/HDFC-TATA CAPITALFI-004418071062124[ID:62124]12-Mar-2018 To Comm.on NEFT:/HDFC-TATA,0,185000,-63978698.34,-63978698.34,0,185000,True,NEFT,39
12-03-2018,12-Mar-18,12-Mar-2018 To Comm.on NEFT:/HDFC-TATACAPITALFI-004418071062124[ID:62124],0,16,-63978714.34,-63978714.34,0,16,True,NEFT,39
13-03-2018,13-Mar-18,13-Mar-2018 By Disc. GEN(BD)7/HundiNo.BERGER/TAL/3013-Mar-2018 To Disc. GEN(BD)7/Hundi,3743301.6,0,-60235412.74,-60235412.74,3743301.6,0,True,Others,39
13-03-2018,13-Mar-18,13-Mar-2018 To Disc. GEN(BD)7/HundiNo.BERGER/TAL/3013-Mar-2018 By Disc. GEN(BD)7/Hundi,0,78968,-60314380.74,-60314380.74,0,78968,True,Others,39
13-03-2018,13-Mar-18,13-Mar-2018 By Disc. GEN(BD)7/HundiNo.BERGER/TAL/02813-Mar-2018 To Disc. GEN(BD)7/Hundi,1202175.9,0,-59112204.84,-59112204.84,1202175.9,0,True,Others,39
13-03-2018,13-Mar-18,13-Mar-2018 To Disc. GEN(BD)7/HundiNo.BERGER/TAL/02813-Mar-2018 To ACH DR HDFC BANK,0,25361,-59137565.84,-59137565.84,0,25361,True,NACH,39
13-03-2018,13-Mar-18,13-Mar-2018 To ACH DR HDFC BANK,0,19408,-59156973.84,-59156973.84,0,19408,True,NACH,39
13-03-2018,13-Mar-18,13-Mar-2018 To RTGS[ID:8603 For120313023790 NOVATECHPROJECTS I PVT LTD],0,1000000,-60156973.84,-60156973.84,0,1000000,True,RTGS,39
13-03-2018,13-Mar-18,13-Mar-2018 To Comm. on RTGS[ID:8603 For120313023790 NOVATECHPROJECTS I PVT LTD],0,64,-60157037.84,-60157037.84,0,64,True,RTGS,39
13-03-2018,13-Mar-18,13-Mar-2018 To NEFT/HDFC-DESHMUKHENGGC-004418072062206[ID:62206],0,25380,-60182417.84,-60182417.84,0,25380,True,NEFT,39
13-03-2018,13-Mar-18,13-Mar-2018 To Comm.onNEFT:/HDFC-DESHMUKH ENGGC-004418072062206[ID:62206],0,6,-60182423.84,-60182423.84,0,6,True,NEFT,39
13-03-2018,13-Mar-18,13-Mar-2018 To NEFT/INDB-INDUSIND BANKL-004418072062222[ID:62222]13-Mar-2018 To Comm.on,0,180136,-60362559.84,-60362559.84,0,180136,True,NEFT,39
13-03-2018,13-Mar-18,13-Mar-2018 To Comm.onNEFT:/INDB-INDUSIND BANKL-004418072062222[ID:62222],0,16,-60362575.84,-60362575.84,0,16,True,NEFT,39
13-03-2018,13-Mar-18,13-Mar-2018 To NEFT/UTIB-IVLFINANCE-004418072062221[ID:62221],0,179511,-60542086.84,-60542086.84,0,179511,True,NEFT,39
13-03-2018,13-Mar-18,13-Mar-2018 To Comm.on NEFT:/UTIB-IVLFINANCE-004418072062221[ID:62221],0,16,-60542102.84,-60542102.84,0,16,True,NEFT,39
13-03-2018,13-Mar-18,13-Mar-2018 To NEFT/IBKL-THE SVC COOPER-004418072062212[ID:62212],0,1000,-60543102.84,-60543102.84,0,1000,True,NEFT,39
13-03-2018,13-Mar-18,13-Mar-2018 To Comm.on NEFT:/IBKL-THESVC COOPER-004418072062212[ID:6221,0,3,-60543105.84,-60543105.84,0,3,True,NEFT,39
13-03-2018,13-Mar-18,13-Mar-2018 To NEFT/IBKL-THE SVC COOPER-004418072062207[ID:62207],0,11375,-60554480.84,-60554480.84,0,11375,True,NEFT,39
13-03-2018,13-Mar-18,13-Mar-2018 To Comm.on NEFT:/IBKL-THESVC COOPER-004418072062207[ID:6220,0,6,-60554486.84,-60554486.84,0,6,True,NEFT,39
13-03-2018,13-Mar-18,13-Mar-2018 To NEFT/SBIN-SHAMSHERBAHADU-004418072062223[ID:62223],0,15000,-60569486.84,-60569486.84,0,15000,True,NEFT,39
13-03-2018,13-Mar-18,13-Mar-2018 To Comm.onNEFT:/SBIN-SHAMSHERBAHADU-004418072062223[ID:6,0,6,-60569492.84,-60569492.84,0,6,True,NEFT,39
14-03-2018,14-Mar-18,14-Mar-2018 To LC-No 173 Retired,0,908000,-61477492.84,-61477492.84,0,908000,True,Others,39
14-03-2018,14-Mar-18,14-Mar-2018 To RTGS[ID:8607 For00600350111290 ADITYA BIRLAFINANCE LTD],0,203544,-61681036.84,-61681036.84,0,203544,True,RTGS,39
14-03-2018,14-Mar-18,14-Mar-2018 To Comm. on RTGS[ID:8607 For00600350111290 ADITYA BIRLAFINANCE LTD],0,32,-61681068.84,-61681068.84,0,32,True,RTGS,39
14-03-2018,14-Mar-18,14-Mar-2018 To NEFT/YESB-RAHULRAJENDRA-004418073062273[ID:62273],0,45000,-61726068.84,-61726068.84,0,45000,True,NEFT,39
14-03-2018,14-Mar-18,14-Mar-2018 To Comm.onNEFT:/YESB-RAHUL RAJENDRA-004418073062273[ID:62273],0,6,-61726074.84,-61726074.84,0,6,True,NEFT,39
14-03-2018,14-Mar-18,14-Mar-2018 To NEFT/IBKL-PRANKRISHNASAN-004418073062274[ID:62274]14-Mar-2018 To Comm.on,0,50000,-61776074.84,-61776074.84,0,50000,True,NEFT,39
14-03-2018,14-Mar-18,14-Mar-2018 To Comm.onNEFT:/IBKL-PRANKRISHNASAN-004418073062274[ID:62274],0,6,-61776080.84,-61776080.84,0,6,True,NEFT,39
14-03-2018,14-Mar-18,14-Mar-2018 To RTGS[ID:8609 For00687610000464 AB ENGG]14-Mar-2018 To Comm. on RTGS[ID:8609 For,0,250000,-62026080.84,-62026080.84,0,250000,True,RTGS,39
14-03-2018,14-Mar-18,14-Mar-2018 To Comm. on RTGS[ID:8609 For00687610000464 AB ENGG]Date Particulars,0,32,-62026112.84,-62026112.84,0,32,True,RTGS,39
14-03-2018,14-Mar-18,14-Mar-2018 To PART COMM AMT ON LC NO193 FOR 2Q@ 1.5%14-Mar-2018 To NEFT/UTIB-AMOL,0,726,-62026838.84,-62026838.84,0,726,True,NEFT,39
14-03-2018,14-Mar-18,14-Mar-2018 To NEFT/UTIB-AMOLLAD-004418073062305[ID:62305]14-Mar-2018 To Comm.on NEFT:/UTIB-AMOL,0,4000,-62030838.84,-62030838.84,0,4000,True,NEFT,39
14-03-2018,14-Mar-18,14-Mar-2018 To Comm.on NEFT:/UTIB-AMOLLAD-004418073062305[ID:62305]14-Mar-2018 To NEFT/IBKL-MAA TARADEVI,0,3,-62030841.84,-62030841.84,0,3,True,NEFT,39
14-03-2018,14-Mar-18,14-Mar-2018 To NEFT/IBKL-MAA TARADEVIBU-004418073062304[ID:62304]14-Mar-2018 To Comm.on NEFT:/IBKL-MAA,0,29942,-62060783.84,-62060783.84,0,29942,True,NEFT,39
14-03-2018,14-Mar-18,14-Mar-2018 To Comm.on NEFT:/IBKL-MAATARADEVIBU-004418073062304[ID:62304],0,6,-62060789.84,-62060789.84,0,6,True,NEFT,39
14-03-2018,14-Mar-18,14-Mar-2018 To NEFT/KKBK-SOUMADEEPSUKUM-004418073062308[ID:62308],0,42391,-62103180.84,-62103180.84,0,42391,True,NEFT,39
14-03-2018,14-Mar-18,14-Mar-2018 To Comm.onNEFT:/KKBK-SOUMADEEPSUKUM-004418073062308[ID:62,0,6,-62103186.84,-62103186.84,0,6,True,NEFT,39
14-03-2018,14-Mar-18,14-Mar-2018 To NEFT/HDFC-ACCLTD-004418073062307[ID:62307]14-Mar-2018 To Comm.on NEFT:/HDFC-ACC,0,100000,-62203186.84,-62203186.84,0,100000,True,NEFT,39
14-03-2018,14-Mar-18,14-Mar-2018 To Comm.on NEFT:/HDFC-ACCLTD-004418073062307[ID:62307]14-Mar-2018 To NEFT/UTIB-AKSHAY,0,6,-62203192.84,-62203192.84,0,6,True,NEFT,39
14-03-2018,14-Mar-18,14-Mar-2018 To NEFT/UTIB-AKSHAYMEHRA-004418073062306[ID:62306],0,30000,-62233192.84,-62233192.84,0,30000,True,NEFT,39
14-03-2018,14-Mar-18,14-Mar-2018 To Comm.onNEFT:/UTIB-AKSHAYMEHRA-004418073062306[ID:62,0,6,-62233198.84,-62233198.84,0,6,True,NEFT,39
14-03-2018,14-Mar-18,14-Mar-2018 To NEFT/UTIB-HARADHANGHOSH-004418073062299[ID:62299],0,7400,-62240598.84,-62240598.84,0,7400,True,NEFT,39
14-03-2018,14-Mar-18,14-Mar-2018 To Comm.onNEFT:/UTIB-HARADHANGHOSH-004418073062299[ID:62,0,3,-62240601.84,-62240601.84,0,3,True,NEFT,39
14-03-2018,14-Mar-18,14-Mar-2018 To NEFT/SBIN-NOVATECHPROJEC-004418073062303[ID:62303],0,100000,-62340601.84,-62340601.84,0,100000,True,NEFT,39
14-03-2018,14-Mar-18,14-Mar-2018 To Comm.onNEFT:/SBIN-NOVATECHPROJEC-004418073062303[ID:62,0,6,-62340607.84,-62340607.84,0,6,True,NEFT,39
15-03-2018,15-Mar-18,15-Mar-2018 To DECS TP-ICICI B143391765915-Mar-2018 To NEFT/SCBL-AEBC CARD NO,0,13680,-62354287.84,-62354287.84,0,13680,True,NEFT,39
15-03-2018,15-Mar-18,15-Mar-2018 To NEFT/SCBL-AEBC CARD NO37-004418074062360[ID:62360]15-Mar-2018 To Comm.on NEFT:/SCBL-AEBC,0,175052,-62529339.84,-62529339.84,0,175052,True,NEFT,39
15-03-2018,15-Mar-18,15-Mar-2018 To Comm.on NEFT:/SCBL-AEBCCARD NO37-004418074062360[ID:62360],0,16,-62529355.84,-62529355.84,0,16,True,NEFT,39
15-03-2018,15-Mar-18,15-Mar-2018 To PO No. Issued.,0,34875,-62564230.84,-62564230.84,0,34875,True,Others,39
15-03-2018,15-Mar-18,15-Mar-2018 PATIL H J,0,26235,-62590465.84,-62590465.84,0,26235,True,Others,39
15-03-2018,15-Mar-18,15-Mar-2018 ELCA LABORATORIESDate Particulars15-Mar-2018 To LEGAL DOCS FRANKING,0,64020,-62654485.84,-62654485.84,0,64020,True,Others,39
15-03-2018,15-Mar-18,15-Mar-2018 To LEGAL DOCS FRANKINGCHGS- SOUMADEEP GHOSHVEHIC,0,3762,-62658247.84,-62658247.84,0,3762,True,CHARGES,39
15-03-2018,15-Mar-18,15-Mar-2018 By MrgRev.GEN(BD)7/1163/HundiNo.NPI/AMB/0024/17-18,308733.4,0,-62349514.44,-62349514.44,308733.400000006,0,True,Others,39
15-03-2018,15-Mar-18,15-Mar-2018 To Hundi No(NPI/AMB/0024/17-18)16-Mar-2018 To DECS HDFC BANK,0,110916,-62460430.44,-62460430.44,0,110916,True,ECS,39
16-03-2018,16-Mar-18,16-Mar-2018 To DECS HDFC BANK4623922316-Mar-2018 To RTGS[ID:8628 For,0,11900,-62472330.44,-62472330.44,0,11900,True,RTGS,39
16-03-2018,16-Mar-18,16-Mar-2018 To RTGS[ID:8628 For00600310014524 TATA CAPITALFINANCIAL SERVICE LTD],0,244816,-62717146.44,-62717146.44,0,244816,True,RTGS,39
16-03-2018,16-Mar-18,16-Mar-2018 To Comm. on RTGS[ID:8628 For00600310014524 TATA CAPITALFINANCIAL SERVICE LTD],0,32,-62717178.44,-62717178.44,0,32,True,RTGS,39
16-03-2018,16-Mar-18,16-Mar-2018 To NEFT/UTIB-MAGMA FINCORPL-004418075062442[ID:62442]16-Mar-2018 To Comm.on,0,161578,-62878756.44,-62878756.44,0,161578,True,NEFT,39
16-03-2018,16-Mar-18,16-Mar-2018 To Comm.onNEFT:/UTIB-MAGMA FINCORPL-004418075062442[ID:62442],0,16,-62878772.44,-62878772.44,0,16,True,NEFT,39
16-03-2018,16-Mar-18,16-Mar-2018 To NEFT/UTIB-MAGMA FINCORPL-004418075062441[ID:62441]16-Mar-2018 To Comm.on,0,121329,-63000101.44,-63000101.44,0,121329,True,NEFT,39
16-03-2018,16-Mar-18,16-Mar-2018 To Comm.onNEFT:/UTIB-MAGMA FINCORPL-004418075062441[ID:62441],0,16,-63000117.44,-63000117.44,0,16,True,NEFT,39
16-03-2018,16-Mar-18,16-Mar-2018 To PART COMM RECOVEREDON LC NO 207 @ 1.5%16-Mar-2018 To PART COMM RECOVERED,0,3606,-63003723.44,-63003723.44,0,3606,True,Others,39
16-03-2018,16-Mar-18,16-Mar-2018 To PART COMM RECOVEREDON LC NO 208 @ 1.5%16-Mar-2018 By Mrg,0,3641,-63007364.44,-63007364.44,0,3641,True,Others,39
16-03-2018,16-Mar-18,16-Mar-2018 By MrgRev.GEN(BD)7/1160/HundiNo.BER/AMB/0024,252400,0,-62754964.44,-62754964.44,252400,0,True,Others,39
16-03-2018,16-Mar-18,16-Mar-2018 To Hundi No (BER/AMB/0024),0,91642,-62846606.44,-62846606.44,0,91642,True,Others,39
16-03-2018,16-Mar-18,16-Mar-2018 By MrgRev.GEN(BD)7/1165/HundiNo.BERGER 015,407756.7,0,-62438849.74,-62438849.74,407756.699999996,0,True,Others,39
16-03-2018,16-Mar-18,16-Mar-2018 To Hundi No (BERGER 015),0,151166,-62590015.74,-62590015.74,0,151166,True,Others,39
16-03-2018,16-Mar-18,16-Mar-2018 By MrgRev.GEN(BD)7/1164/HundiNo.BEERGER/025,309757.4,0,-62280258.34,-62280258.34,309757.399999999,0,True,Others,39
16-03-2018,16-Mar-18,16-Mar-2018 To Hundi No (BEERGER/025),0,104180,-62384438.34,-62384438.34,0,104180,True,Others,39
16-03-2018,16-Mar-18,16-Mar-2018 To COMMISSION OF LC NO 191ISSUED BY AXIS BANK16-Mar-2018 To COMMISSION OF LC NO 192,0,7370,-62391808.34,-62391808.34,0,7370,True,CHARGES,39
16-03-2018,16-Mar-18,16-Mar-2018 To COMMISSION OF LC NO 192ISSUED BY AXIS BANK16-Mar-2018 To COMMISSION OF LC NO 199,0,8898,-62400706.34,-62400706.34,0,8898,True,CHARGES,39
16-03-2018,16-Mar-18,16-Mar-2018 To COMMISSION OF LC NO 199ISSUED BY AXIS BANK17-Mar-2018 By RTGS ID:8637 [From,0,14049,-62414755.34,-62414755.34,0,14049,True,CHARGES,39
17-03-2018,17-Mar-18,17-Mar-2018 By RTGS ID:8637 [From0512234153 FORWARDEXPORTS PRIVATE LIMITED,800000,0,-61614755.34,-61614755.34,800000,0,True,RTGS,39
17-03-2018,17-Mar-18,17-Mar-2018 To NEFT/UTIB-ROHITBHOIR-004418076062536[ID:62536],0,71487,-61686242.34,-61686242.34,0,71487,True,NEFT,39
17-03-2018,17-Mar-18,17-Mar-2018 To Comm.on NEFT:/UTIB-ROHITBHOIR-004418076062536[ID:62536],0,6,-61686248.34,-61686248.34,0,6,True,NEFT,39
17-03-2018,17-Mar-18,17-Mar-2018 To NEFT/CNRB-ANANTAPRASADL-004418076062535[ID:62535],0,43075,-61729323.34,-61729323.34,0,43075,True,NEFT,39
17-03-2018,17-Mar-18,17-Mar-2018 To Comm.onNEFT:/CNRB-ANANTA PRASADL-004418076062535[ID:62535],0,6,-61729329.34,-61729329.34,0,6,True,NEFT,39
17-03-2018,17-Mar-18,17-Mar-2018 To NEFT/UTIB-SHAHANWAZALAM-004418076062543[ID:62543],0,10000,-61739329.34,-61739329.34,0,10000,True,NEFT,39
17-03-2018,17-Mar-18,17-Mar-2018 To Comm.onNEFT:/UTIB-SHAHANWAZALAM-004418076062543[ID:6254,0,3,-61739332.34,-61739332.34,0,3,True,NEFT,39
17-03-2018,17-Mar-18,17-Mar-2018 KOTAK MAHINDRA BANK LTD,0,146889,-61886221.34,-61886221.34,0,146889,True,Others,39
17-03-2018,17-Mar-18,17-Mar-2018 AMIT FASTENERS,0,156267,-62042488.34,-62042488.34,0,156267,True,Others,39
17-03-2018,17-Mar-18,17-Mar-2018 NOORI INDUSTRIAL GASES,0,176185,-62218673.34,-62218673.34,0,176185,True,Others,39
17-03-2018,17-Mar-18,17-Mar-2018 By Disc. GEN(BD)7/HundiNo.KCC/13517-Mar-2018 To Disc. GEN(BD)7/Hundi,1117458.9,0,-61101214.44,-61101214.44,1117458.90000001,0,True,Others,39
17-03-2018,17-Mar-18,17-Mar-2018 To Disc. GEN(BD)7/HundiNo.KCC/13517-Mar-2018 By Disc. GEN(BD)7/Hundi,0,24247,-61125461.44,-61125461.44,0,24247,True,Others,39
17-03-2018,17-Mar-18,17-Mar-2018 By Disc. GEN(BD)7/HundiNo.KCC/13617-Mar-2018 To Disc. GEN(BD)7/Hundi,1151997.3,0,-59973464.14,-59973464.14,1151997.3,0,True,Others,39
17-03-2018,17-Mar-18,17-Mar-2018 To Disc. GEN(BD)7/HundiNo.KCC/13617-Mar-2018 By Disc. GEN(BD)7/Hundi,0,24997,-59998461.14,-59998461.14,0,24997,True,Others,39
17-03-2018,17-Mar-18,17-Mar-2018 By Disc. GEN(BD)7/HundiNo.BGR/13717-Mar-2018 To Disc. GEN(BD)7/Hundi,1166929.2,0,-58831531.94,-58831531.94,1166929.2,0,True,Others,39
17-03-2018,17-Mar-18,17-Mar-2018 To Disc. GEN(BD)7/HundiNo.BGR/13717-Mar-2018 By Disc. GEN(BD)7/Hundi,0,25672,-58857203.94,-58857203.94,0,25672,True,Others,39
17-03-2018,17-Mar-18,17-Mar-2018 By Disc. GEN(BD)7/HundiNo.BGR/13817-Mar-2018 To Disc. GEN(BD)7/Hundi,1257668.1,0,-57599535.84,-57599535.84,1257668.09999999,0,True,Others,39
17-03-2018,17-Mar-18,17-Mar-2018 To Disc. GEN(BD)7/HundiNo.BGR/13817-Mar-2018 By Disc. GEN(BD)7/Hundi,0,27669,-57627204.84,-57627204.84,0,27669,True,Others,39
17-03-2018,17-Mar-18,17-Mar-2018 By Disc. GEN(BD)7/HundiNo.BER/6617-Mar-2018 To Disc. GEN(BD)7/Hundi,2124000,0,-55503204.84,-55503204.84,2124000,0,True,Others,39
17-03-2018,17-Mar-18,17-Mar-2018 To Disc. GEN(BD)7/HundiNo.BER/6617-Mar-2018 To Self,0,42887,-55546091.84,-55546091.84,0,42887,True,CASH,39
17-03-2018,17-Mar-18,17-Mar-2018 To Self,0,50000,-55596091.84,-55596091.84,0,50000,True,CASH,39
19-03-2018,19-Mar-18,19-Mar-2018 MSEDCL,0,24520,-55620611.84,-55620611.84,0,24520,True,Others,39
19-03-2018,19-Mar-18,19-Mar-2018 MSEDCL,0,40380,-55660991.84,-55660991.84,0,40380,True,Others,39
19-03-2018,19-Mar-18,19-Mar-2018 RANU GAS SERVICE,0,6313,-55667304.84,-55667304.84,0,6313,True,Others,39
19-03-2018,19-Mar-18,19-Mar-2018 MSEDCL,0,36710,-55704014.84,-55704014.84,0,36710,True,Others,39
19-03-2018,19-Mar-18,19-Mar-2018 MSEDCLDate Particulars19-Mar-2018 MSEDCL,0,35730,-55739744.84,-55739744.84,0,35730,True,Others,39
19-03-2018,19-Mar-18,19-Mar-2018 MSEDCL,0,68450,-55808194.84,-55808194.84,0,68450,True,Others,39
19-03-2018,19-Mar-18,19-Mar-2018 MSEDCL,0,22780,-55830974.84,-55830974.84,0,22780,True,Others,39
19-03-2018,19-Mar-18,19-Mar-2018 To Commission Charged onLC/No.20919-Mar-2018 To Service Charges Charged on,0,17729,-55848703.84,-55848703.84,0,17729,True,CHARGES,39
19-03-2018,19-Mar-18,19-Mar-2018 To Service Charges Charged onLC/No.20919-Mar-2018 To NEFT/ICIC-YAMALL,0,1180,-55849883.84,-55849883.84,0,1180,True,CHARGES,39
19-03-2018,19-Mar-18,19-Mar-2018 To NEFT/ICIC-YAMALLSOLUTION-004418078062656[ID:62656],0,4000000,-59849883.84,-59849883.84,0,4000000,True,NEFT,39
19-03-2018,19-Mar-18,19-Mar-2018 To Comm.onNEFT:/ICIC-YAMALLSOLUTION-004418078062656[ID:,0,29,-59849912.84,-59849912.84,0,29,True,NEFT,39
19-03-2018,19-Mar-18,19-Mar-2018 To NEFT/BARB-SUMANA AVIJITG-004418078062657[ID:62657]19-Mar-2018 To Comm.on,0,15136,-59865048.84,-59865048.84,0,15136,True,NEFT,39
19-03-2018,19-Mar-18,19-Mar-2018 To Comm.onNEFT:/BARB-SUMANA AVIJITG-004418078062657[ID:62657],0,6,-59865054.84,-59865054.84,0,6,True,NEFT,39
20-03-2018,20-Mar-18,20-Mar-2018 To NEFT/SBIN-AKHILESHSHUKLA-004418079062706[ID:62706],0,125000,-59990054.84,-59990054.84,0,125000,True,NEFT,39
20-03-2018,20-Mar-18,20-Mar-2018 To Comm.onNEFT:/SBIN-AKHILESHSHUKLA-004418079062706[ID:62,0,16,-59990070.84,-59990070.84,0,16,True,NEFT,39
20-03-2018,20-Mar-18,20-Mar-2018 To NEFT/RATN-NOVATECHPROJEC-004418079062714[ID:62714],0,98440,-60088510.84,-60088510.84,0,98440,True,NEFT,39
20-03-2018,20-Mar-18,20-Mar-2018 To Comm.onNEFT:/RATN-NOVATECHPROJEC-004418079062714[ID:62,0,6,-60088516.84,-60088516.84,0,6,True,NEFT,39
20-03-2018,20-Mar-18,20-Mar-2018 To RTGS[ID:8662 For 0112396848INESH ACCERRO LTD]20-Mar-2018 To Comm. on RTGS[ID:8662 For,0,1000000,-61088516.84,-61088516.84,0,1000000,True,RTGS,39
20-03-2018,20-Mar-18,20-Mar-2018 To Comm. on RTGS[ID:8662 For0112396848 INESH ACCERROLTD],0,60,-61088576.84,-61088576.84,0,60,True,RTGS,39
20-03-2018,20-Mar-18,20-Mar-2018 To RTGS[ID:8665 For1756002100016951 OSIA EXIMPVT LTD],0,3209200,-64297776.84,-64297776.84,0,3209200,True,RTGS,39
20-03-2018,20-Mar-18,20-Mar-2018 To Comm. on RTGS[ID:8665 For1756002100016951 OSIA EXIMPVT LTD],0,64,-64297840.84,-64297840.84,0,64,True,RTGS,39
20-03-2018,20-Mar-18,20-Mar-2018 To RTGS[ID:8666 For50200002533335 DELTA P DPUMPS PVT LTD],0,319288,-64617128.84,-64617128.84,0,319288,True,RTGS,39
20-03-2018,20-Mar-18,20-Mar-2018 To Comm. on RTGS[ID:8666 For50200002533335 DELTA P DPUMPS PVT LTD],0,35,-64617163.84,-64617163.84,0,35,True,RTGS,39
20-03-2018,20-Mar-18,20-Mar-2018 BUDHAJI MAYA PATIL,0,5400,-64622563.84,-64622563.84,0,5400,True,Others,39
20-03-2018,20-Mar-18,20-Mar-2018 By RTGS ID:8667 [From021105500377 MANISHAENTERPRISE 209THE SUMMIT,374663,0,-64247900.84,-64247900.84,374663,0,True,RTGS,39
20-03-2018,20-Mar-18,20-Mar-2018 By RTGS ID:8668 [From021105500377 MANISHAENTERPRISE 209THE SUMMIT,359104,0,-63888796.84,-63888796.84,359104,0,True,RTGS,39
20-03-2018,20-Mar-18,20-Mar-2018 By RTGS ID:8672 [From021105500377 MANISHAENTERPRISE 209THE SUMMIT,725905,0,-63162891.84,-63162891.84,725905,0,True,RTGS,39
20-03-2018,20-Mar-18,20-Mar-2018 By RTGS ID:8673 [From021105500377 MANISHAENTERPRISE 209THE SUMMIT,977523,0,-62185368.84,-62185368.84,977523,0,True,RTGS,39
20-03-2018,20-Mar-18,20-Mar-2018 By RTGS ID:8674 [From021105500377 MANISHAENTERPRISE 209THE SUMMIT,575100,0,-61610268.84,-61610268.84,575100,0,True,RTGS,39
20-03-2018,20-Mar-18,20-Mar-2018 By RTGS ID:8675 [From021105500377 MANISHAENTERPRISE 209THE SUMMIT,975560,0,-60634708.84,-60634708.84,975560,0,True,RTGS,39
20-03-2018,20-Mar-18,20-Mar-2018 By RTGS ID:8669 FROM2460505342 M/S NOVATECHPROJE,4000000,0,-56634708.84,-56634708.84,4000000,0,True,RTGS,39
20-03-2018,20-Mar-18,20-Mar-2018 To REALISATION OF BILLS,0,7632351,-64267059.84,-64267059.84,0,7632351,True,Others,39
20-03-2018,20-Mar-18,20-Mar-2018 By MrgRev.GEN(BD)7/1155/HundiNo.BHEL/070,176084.6,0,-64090975.24,-64090975.24,176084.600000002,0,True,Others,39
20-03-2018,20-Mar-18,20-Mar-2018 To Hundi No (BHEL/070),0,54511,-64145486.24,-64145486.24,0,54511,True,Others,39
20-03-2018,20-Mar-18,20-Mar-2018 By MrgRev.GEN(BD)7/1156/HundiNo.BHEL/71,118514.6,0,-64026971.64,-64026971.64,118514.600000002,0,True,Others,39
20-03-2018,20-Mar-18,20-Mar-2018 To Hundi No (BHEL/71),0,36689,-64063660.64,-64063660.64,0,36689,True,Others,39
20-03-2018,20-Mar-18,20-Mar-2018 By MrgRev.GEN(BD)7/1166/HundiNo.BERGER 031,160889.2,0,-63902771.44,-63902771.44,160889.200000003,0,True,Others,39
20-03-2018,20-Mar-18,20-Mar-2018 To Hundi No (BERGER 031),0,38739,-63941510.44,-63941510.44,0,38739,True,Others,39
20-03-2018,20-Mar-18,20-Mar-2018 By MrgRev.GEN(BD)7/1167/HundiNo.NPI/AMB/0035/17-18,154366.7,0,-63787143.74,-63787143.74,154366.699999996,0,True,Others,39
20-03-2018,20-Mar-18,20-Mar-2018 To Hundi No(NPI/AMB/0035/17-18)20-Mar-2018 By Mrg,0,30679,-63817822.74,-63817822.74,0,30679,True,Others,39
20-03-2018,20-Mar-18,20-Mar-2018 By MrgRev.GEN(BD)7/1168/HundiNo.NPI/AMB/0035A,154366.7,0,-63663456.04,-63663456.04,154366.700000003,0,True,Others,39
20-03-2018,20-Mar-18,20-Mar-2018 To Hundi No (NPI/AMB/0035A),0,30679,-63694135.04,-63694135.04,0,30679,True,Others,39
21-03-2018,21-Mar-18,21-Mar-2018 To RTGS[ID:8680 For00600310013437 ACC LTD]21-Mar-2018 To Comm. on RTGS[ID:8680 For,0,405000,-64099135.04,-64099135.04,0,405000,True,RTGS,39
21-03-2018,21-Mar-18,21-Mar-2018 To Comm. on RTGS[ID:8680 For00600310013437 ACC LTD]21-Mar-2018 To NEFT/SBIN-NOVATECH,0,32,-64099167.04,-64099167.04,0,32,True,RTGS,39
21-03-2018,21-Mar-18,21-Mar-2018 To NEFT/SBIN-NOVATECHPROJEC-004418080062789[ID:62789],0,160000,-64259167.04,-64259167.04,0,160000,True,NEFT,39
21-03-2018,21-Mar-18,21-Mar-2018 To Comm.onNEFT:/SBIN-NOVATECHPROJEC-004418080062789[ID:62,0,16,-64259183.04,-64259183.04,0,16,True,NEFT,39
21-03-2018,21-Mar-18,21-Mar-2018 RICHA AJAYKUMAR SHARMA,0,10720,-64269903.04,-64269903.04,0,10720,True,Others,39
21-03-2018,21-Mar-18,21-Mar-2018 By Disc. GEN(BD)7/HundiNo.RFCL/6721-Mar-2018 To Disc. GEN(BD)7/Hundi,11559199.5,0,-52710703.54,-52710703.54,11559199.5,0,True,Others,39
21-03-2018,21-Mar-18,21-Mar-2018 To Disc. GEN(BD)7/HundiNo.RFCL/6722-Mar-2018 To RTGS[ID:8693 For 0112396848,0,240368,-52951071.54,-52951071.54,0,240368,True,RTGS,39
22-03-2018,22-Mar-18,22-Mar-2018 To RTGS[ID:8693 For 0112396848INESH ACCERRO LTD]22-Mar-2018 To Comm. on RTGS[ID:8693 For,0,1000000,-53951071.54,-53951071.54,0,1000000,True,RTGS,39
22-03-2018,22-Mar-18,22-Mar-2018 To Comm. on RTGS[ID:8693 For0112396848 INESH ACCERROLTD],0,60,-53951131.54,-53951131.54,0,60,True,RTGS,39
22-03-2018,22-Mar-18,22-Mar-2018 To RTGS[ID:8694 For501200381000001 NATIONALSMALL INDUSTRIES,0,10000000,-63951131.54,-63951131.54,0,10000000,True,RTGS,39
22-03-2018,22-Mar-18,22-Mar-2018 To Comm. on RTGS[ID:8694 For501200381000001 NATIONALSMALL INDUSTRIES,0,64,-63951195.54,-63951195.54,0,64,True,RTGS,39
23-03-2018,23-Mar-18,23-Mar-2018 To RTGS[ID:8702 For315801010036163 JAY LAXMIFABRICATORS],0,255000,-64206195.54,-64206195.54,0,255000,True,RTGS,39
23-03-2018,23-Mar-18,23-Mar-2018 To Comm. on RTGS[ID:8702 For315801010036163 JAY LAXMIFABRICATORS],0,29,-64206224.54,-64206224.54,0,29,True,RTGS,39
23-03-2018,23-Mar-18,23-Mar-2018 To NEFT/UTIB-SHAHANWAZALAM-004418082062916[ID:62916],0,15000,-64221224.54,-64221224.54,0,15000,True,NEFT,39
23-03-2018,23-Mar-18,23-Mar-2018 To Comm.onNEFT:/UTIB-SHAHANWAZALAM-004418082062916[ID:6291,0,6,-64221230.54,-64221230.54,0,6,True,NEFT,39
23-03-2018,23-Mar-18,23-Mar-2018 To NEFT/IBKL-THE SVC COOPER-004418082062917[ID:62917],0,14625,-64235855.54,-64235855.54,0,14625,True,NEFT,39
23-03-2018,23-Mar-18,23-Mar-2018 To Comm.on NEFT:/IBKL-THESVC COOPER-004418082062917[ID:6291,0,6,-64235861.54,-64235861.54,0,6,True,NEFT,39
23-03-2018,23-Mar-18,23-Mar-2018 To RTGS[ID:8711 For020150050801203 MAHAARACONSTRUCTION],0,490000,-64725861.54,-64725861.54,0,490000,True,RTGS,39
23-03-2018,23-Mar-18,23-Mar-2018 To Comm. on RTGS[ID:8711 For020150050801203 MAHAARACONSTRUCTION],0,35,-64725896.54,-64725896.54,0,35,True,RTGS,39
23-03-2018,23-Mar-18,23-Mar-2018 To Commission Charged onLC/No.21023-Mar-2018 To Service Charges Charged on,0,8290,-64734186.54,-64734186.54,0,8290,True,CHARGES,39
23-03-2018,23-Mar-18,23-Mar-2018 To Service Charges Charged onLC/No.21026-Mar-2018 To SI TL/B-LOAN/180,0,1180,-64735366.54,-64735366.54,0,1180,True,CHARGES,39
26-03-2018,26-Mar-18,26-Mar-2018 To SI TL/B-LOAN/180,0,14500,-64749866.54,-64749866.54,0,14500,True,ECS,39
26-03-2018,26-Mar-18,26-Mar-2018 by o/w-24/417-EVEREST BANKLIMITEDDate Particulars,1600000,0,-63149866.54,-63149866.54,1600000,0,True,OUTWARD,39
26-03-2018,26-Mar-18,26-Mar-2018 by o/w-240/2-BERGER PAINTSINDIA LIMITED26-Mar-2018 To NEFT/BOFA-PRAXAIR INDIA,14868,0,-63134998.54,-63134998.54,14868,0,True,OUTWARD,39
26-03-2018,26-Mar-18,26-Mar-2018 To NEFT/BOFA-PRAXAIR INDIAP-004418085063034[ID:63034]26-Mar-2018 To Comm.on,0,60855,-63195853.54,-63195853.54,0,60855,True,NEFT,39
26-03-2018,26-Mar-18,26-Mar-2018 To Comm.onNEFT:/BOFA-PRAXAIR INDIAP-004418085063034[ID:63034],0,6,-63195859.54,-63195859.54,0,6,True,NEFT,39
26-03-2018,26-Mar-18,26-Mar-2018 To RTGS[ID:8720 For00140310008204 BERGERPAINTS INDIA LIMITED],0,526840,-63722699.54,-63722699.54,0,526840,True,RTGS,39
26-03-2018,26-Mar-18,26-Mar-2018 To Comm. on RTGS[ID:8720 For00140310008204 BERGERPAINTS INDIA LIMITED],0,60,-63722759.54,-63722759.54,0,60,True,RTGS,39
26-03-2018,26-Mar-18,26-Mar-2018 SHAMSHER BAHADURMAURYA26-Mar-2018 SAI INSPECTION SERVICES,0,8000,-63730759.54,-63730759.54,0,8000,True,Others,39
26-03-2018,26-Mar-18,26-Mar-2018 SAI INSPECTION SERVICES,0,57218,-63787977.54,-63787977.54,0,57218,True,Others,39
26-03-2018,26-Mar-18,26-Mar-2018 To Commission Charged onLC/No.21426-Mar-2018 To Service Charges Charged on,0,11341,-63799318.54,-63799318.54,0,11341,True,CHARGES,39
26-03-2018,26-Mar-18,26-Mar-2018 To Service Charges Charged onLC/No.21426-Mar-2018 To TD/FDL/11570,0,1180,-63800498.54,-63800498.54,0,1180,True,CHARGES,39
26-03-2018,26-Mar-18,26-Mar-2018 To TD/FDL/11570,0,1000000,-64800498.54,-64800498.54,0,1000000,True,Others,39
26-03-2018,26-Mar-18,26-Mar-2018 To Commission Charged onLC/No.21526-Mar-2018 To Service Charges Charged on,0,17748,-64818246.54,-64818246.54,0,17748,True,CHARGES,39
26-03-2018,26-Mar-18,26-Mar-2018 To Service Charges Charged onLC/No.21526-Mar-2018 To Commission Charged on,0,1180,-64819426.54,-64819426.54,0,1180,True,CHARGES,39
26-03-2018,26-Mar-18,26-Mar-2018 To Commission Charged onLC/No.21626-Mar-2018 To Service Charges Charged on,0,9226,-64828652.54,-64828652.54,0,9226,True,CHARGES,39
26-03-2018,26-Mar-18,26-Mar-2018 To Service Charges Charged onLC/No.21626-Mar-2018 To Commission Charged on,0,1180,-64829832.54,-64829832.54,0,1180,True,CHARGES,39
26-03-2018,26-Mar-18,26-Mar-2018 To Commission Charged onLC/No.21726-Mar-2018 To Service Charges Charged on,0,44250,-64874082.54,-64874082.54,0,44250,True,CHARGES,39
26-03-2018,26-Mar-18,26-Mar-2018 To Service Charges Charged onLC/No.21726-Mar-2018 By RTGS ID:8733 [From,0,1180,-64875262.54,-64875262.54,0,1180,True,CHARGES,39
26-03-2018,26-Mar-18,26-Mar-2018 By RTGS ID:8733 [From002805002875 SIDDHIVINAYAKENTERPRISE,500000,0,-64375262.54,-64375262.54,500000,0,True,RTGS,39
26-03-2018,26-Mar-18,26-Mar-2018 To NEFT/HDFC-VISHALTRADING-004418085063067[ID:63067],0,100000,-64475262.54,-64475262.54,0,100000,True,NEFT,39
26-03-2018,26-Mar-18,26-Mar-2018 To Comm.onNEFT:/HDFC-VISHAL TRADING-004418085063067[ID:63067],0,6,-64475268.54,-64475268.54,0,6,True,NEFT,39
26-03-2018,26-Mar-18,26-Mar-2018 To PART LC COMMISSIONRECOVERED ON LC 206@0.015,0,358,-64475626.54,-64475626.54,0,358,True,CHARGES,39
27-03-2018,27-Mar-18,27-Mar-2018 To NEFT/SYNB-MUNNACUTTINGW-004418086063126[ID:63126],0,10204,-64485830.54,-64485830.54,0,10204,True,NEFT,39
27-03-2018,27-Mar-18,27-Mar-2018 To Comm.onNEFT:/SYNB-MUNNA CUTTINGW-004418086063126[ID:63126],0,6,-64485836.54,-64485836.54,0,6,True,NEFT,39
27-03-2018,27-Mar-18,27-Mar-2018 By RTGS ID:8744 From120313023790NOVATECHPROJECTS (INDIA) PVT LTD601,3500000,0,-60985836.54,-60985836.54,3500000,0,True,RTGS,39
27-03-2018,27-Mar-18,27-Mar-2018 To REALISATION OF BILLSNPI/TAL/001727-Mar-2018 By Mrg,0,2846136,-63831972.54,-63831972.54,0,2846136,True,Others,39
27-03-2018,27-Mar-18,27-Mar-2018 By MrgRev.GEN(BD)7/1171/HundiNo.NPI/TAL/0017,284613.6,0,-63547358.94,-63547358.94,284613.600000001,0,True,Others,39
27-03-2018,27-Mar-18,27-Mar-2018 To Hundi No (NPI/TAL/0017),0,44599,-63591957.94,-63591957.94,0,44599,True,Others,39
28-03-2018,28-Mar-18,28-Mar-2018 To Self,0,700000,-64291957.94,-64291957.94,0,700000,True,CASH,39
28-03-2018,28-Mar-18,28-Mar-2018 P M JAGANNATHAN,0,34650,-64326607.94,-64326607.94,0,34650,True,Others,39
28-03-2018,28-Mar-18,28-Mar-2018 By NEFT ID:63336 [From CLIXCAPITAL SERVICES PVT LTD]28-Mar-2018 By Disc. GEN(BD)7/Hundi,2429194.44,0,-61897413.5,-61897413.5,2429194.44,0,True,NEFT,39
28-03-2018,28-Mar-18,28-Mar-2018 By Disc. GEN(BD)7/HundiNo.GACL/6928-Mar-2018 To Disc. GEN(BD)7/Hundi,2522390.4,0,-59375023.1,-59375023.1,2522390.4,0,True,Others,39
28-03-2018,28-Mar-18,"28-Mar-2018 To Disc. GEN(BD)7/HundiNo.GACL/6928-Mar-2018 To REAL OF BIILS TAL/0016,",0,51692,-59426715.1,-59426715.1,0,51692,True,Others,39
28-03-2018,28-Mar-18,"28-Mar-2018 To REAL OF BIILS TAL/0016,BHEL/09228-Mar-2018 By Mrg",0,2723468,-62150183.1,-62150183.1,0,2723468,True,Others,39
28-03-2018,28-Mar-18,28-Mar-2018 By MrgRev.GEN(BD)7/1169/HundiNo.NPI/TAL/0016,103823.8,0,-62046359.3,-62046359.3,103823.800000005,0,True,Others,39
28-03-2018,28-Mar-18,28-Mar-2018 To Hundi No (NPI/TAL/0016),0,16666,-62063025.3,-62063025.3,0,16666,True,Others,39
28-03-2018,28-Mar-18,28-Mar-2018 By MrgRev.GEN(BD)7/1170/HundiNo.BHEL/092,168523,0,-61894502.3,-61894502.3,168523,0,True,Others,39
28-03-2018,28-Mar-18,28-Mar-2018 To Hundi No (BHEL/092),0,18678,-61913180.3,-61913180.3,0,18678,True,Others,39
29-03-2018,29-Mar-18,29-Mar-2018 MALLIK ENGINEERING WORKS,0,19300,-61932480.3,-61932480.3,0,19300,True,Others,39
31-03-2018,31-Mar-18,31-Mar-2018 To Folio Chrgs01/01/2018-31/03/201831-Mar-2018 To LC-No 170 Retired,0,900,-61933380.3,-61933380.3,0,900,True,CHARGES,39
31-03-2018,31-Mar-18,31-Mar-2018 To LC-No 170 Retired,0,2409560,-64342940.3,-64342940.3,0,2409560,True,Others,39
31-03-2018,31-Mar-18,31-Mar-2018 To INT @ 8.5% FOR 90 DAYSON LC NO 170 J D STEEL31-Mar-2018 To NEFT/IBKL-SVC CO,0,50502,-64393442.3,-64393442.3,0,50502,True,NEFT,39
31-03-2018,31-Mar-18,31-Mar-2018 To NEFT/IBKL-SVC COOPERATIV-004418090063539[ID:63539],0,113750,-64507192.3,-64507192.3,0,113750,True,NEFT,39
31-03-2018,31-Mar-18,31-Mar-2018 To Comm.on NEFT:/IBKL-SVCCOOPERATIV-004418090063539[ID:,0,16,-64507208.3,-64507208.3,0,16,True,NEFT,39
31-03-2018,31-Mar-18,31-Mar-2018 To NEFT/IBKL-SVC COOPERATIV-004418090063535[ID:63535],0,43700,-64550908.3,-64550908.3,0,43700,True,NEFT,39
31-03-2018,31-Mar-18,31-Mar-2018 To Comm.on NEFT:/IBKL-SVCCOOPERATIV-004418090063535[ID:,0,6,-64550914.3,-64550914.3,0,6,True,NEFT,39
31-03-2018,31-Mar-18,31-Mar-2018 To NEFT/IBKL-SVC COOPERATIV-004418090063532[ID:63532],0,110250,-64661164.3,-64661164.3,0,110250,True,NEFT,39
31-03-2018,31-Mar-18,31-Mar-2018 To Comm.on NEFT:/IBKL-SVCCOOPERATIV-004418090063532[ID:,0,16,-64661180.3,-64661180.3,0,16,True,NEFT,39
31-03-2018,31-Mar-18,31-Mar-2018 To NEFT/IBKL-SVC COOPERATIV-004418090063530[ID:63530],0,7032,-64668212.3,-64668212.3,0,7032,True,NEFT,39
31-03-2018,31-Mar-18,31-Mar-2018 To Comm.on NEFT:/IBKL-SVCCOOPERATIV-004418090063530[ID:,0,3,-64668215.3,-64668215.3,0,3,True,NEFT,39
31-03-2018,31-Mar-18,31-Mar-2018 To NEFT/IBKL-THE SVC COOPER-004418090063528[ID:63528],0,63527,-64731742.3,-64731742.3,0,63527,True,NEFT,39
31-03-2018,31-Mar-18,31-Mar-2018 To Comm.on NEFT:/IBKL-THESVC COOPER-004418090063528[ID:6352,0,6,-64731748.3,-64731748.3,0,6,True,NEFT,39
31-03-2018,31-Mar-18,31-Mar-2018 To NEFT/IBKL-THE SVC COOPER-004418090063527[ID:63527],0,520,-64732268.3,-64732268.3,0,520,True,NEFT,39
31-03-2018,31-Mar-18,31-Mar-2018 To Comm.on NEFT:/IBKL-THESVC COOPER-004418090063527[ID:6352,0,3,-64732271.3,-64732271.3,0,3,True,NEFT,39
31-03-2018,31-Mar-18,31-Mar-2018 To NEFT/IBKL-THE SVC COOPER-004418090063526[ID:63526],0,101086,-64833357.3,-64833357.3,0,101086,True,NEFT,39
31-03-2018,31-Mar-18,31-Mar-2018 To Comm.on NEFT:/IBKL-THESVC COOPER-004418090063526[ID:6352,0,16,-64833373.3,-64833373.3,0,16,True,NEFT,39
31-03-2018,31-Mar-18,31-Mar-2018 To NEFT/IBKL-THE SVC COOPER-004418090063524[ID:63524],0,10914,-64844287.3,-64844287.3,0,10914,True,NEFT,39
31-03-2018,31-Mar-18,31-Mar-2018 To Comm.on NEFT:/IBKL-THESVC COOPER-004418090063524[ID:6352,0,6,-64844293.3,-64844293.3,0,6,True,NEFT,39
31-03-2018,31-Mar-18,31-Mar-2018 To NEFT/IBKL-THE SVC COOPER-004418090063522[ID:63522],0,147014,-64991307.3,-64991307.3,0,147014,True,NEFT,39
31-03-2018,31-Mar-18,31-Mar-2018 To Comm.on NEFT:/IBKL-THESVC COOPER-004418090063522[ID:6352,0,16,-64991323.3,-64991323.3,0,16,True,NEFT,39
31-03-2018,31-Mar-18,31-Mar-2018 To NEFT/IBKL-THE SVC COOPER-004418090063521[ID:63521],0,60675,-65051998.3,-65051998.3,0,60675,True,NEFT,39
31-03-2018,31-Mar-18,31-Mar-2018 To Comm.on NEFT:/IBKL-THESVC COOPER-004418090063521[ID:6352,0,6,-65052004.3,-65052004.3,0,6,True,NEFT,39
31-03-2018,31-Mar-18,31-Mar-2018 To NEFT/IBKL-THE SVC COOPER-004418090063520[ID:63520],0,33684,-65085688.3,-65085688.3,0,33684,True,NEFT,39
31-03-2018,31-Mar-18,31-Mar-2018 To Comm.on NEFT:/IBKL-THESVC COOPER-004418090063520[ID:6352,0,6,-65085694.3,-65085694.3,0,6,True,NEFT,39
31-03-2018,31-Mar-18,31-Mar-2018 To NEFT/IBKL-THE SVC COOPER-004418090063519[ID:63519],0,32788,-65118482.3,-65118482.3,0,32788,True,NEFT,39
31-03-2018,31-Mar-18,31-Mar-2018 To Comm.on NEFT:/IBKL-THESVC COOPER-004418090063519[ID:6351,0,6,-65118488.3,-65118488.3,0,6,True,NEFT,39
31-03-2018,31-Mar-18,31-Mar-2018 To NEFT/IBKL-THE SVC COOPER-004418090063516[ID:63516],0,41851,-65160339.3,-65160339.3,0,41851,True,NEFT,39
31-03-2018,31-Mar-18,31-Mar-2018 To Comm.on NEFT:/IBKL-THESVC COOPER-004418090063516[ID:6351,0,6,-65160345.3,-65160345.3,0,6,True,NEFT,39
31-03-2018,31-Mar-18,31-Mar-2018 By Disc. GEN(BD)7/HundiNo.GACL/6431-Mar-2018 To Disc. GEN(BD)7/Hundi,3397148.1,0,-61763197.2,-61763197.2,3397148.09999999,0,True,Others,39
31-03-2018,31-Mar-18,31-Mar-2018 To Disc. GEN(BD)7/HundiNo.GACL/6431-Mar-2018 To NEFT/IBKL-THE SVC CO,0,49142,-61812339.2,-61812339.2,0,49142,True,NEFT,39
31-03-2018,31-Mar-18,31-Mar-2018 To NEFT/IBKL-THE SVC COOPER-004418090063515[ID:63515],0,51774,-61864113.2,-61864113.2,0,51774,True,NEFT,39
31-03-2018,31-Mar-18,31-Mar-2018 To Comm.on NEFT:/IBKL-THESVC COOPER-004418090063515[ID:6351,0,6,-61864119.2,-61864119.2,0,6,True,NEFT,39
31-03-2018,31-Mar-18,31-Mar-2018 To NEFT/IBKL-THE SVCCO-OPER-004418090063533[ID:63533],0,36200,-61900319.2,-61900319.2,0,36200,True,NEFT,39
31-03-2018,31-Mar-18,31-Mar-2018 To Comm.on NEFT:/IBKL-THESVCCO-OPER-004418090063533[ID:6,0,6,-61900325.2,-61900325.2,0,6,True,NEFT,39
31-03-2018,31-Mar-18,31-Mar-2018 To NEFT/IBKL-THE SVCCO-OPER-004418090063531[ID:63531],0,54600,-61954925.2,-61954925.2,0,54600,True,NEFT,39
31-03-2018,31-Mar-18,31-Mar-2018 To Comm.on NEFT:/IBKL-THESVCCO-OPER-004418090063531[ID:6,0,6,-61954931.2,-61954931.2,0,6,True,NEFT,39
31-03-2018,31-Mar-18,31-Mar-2018 To NEFT/IBKL-THE SVCCO-OPER-004418090063534[ID:63534],0,17800,-61972731.2,-61972731.2,0,17800,True,NEFT,39
31-03-2018,31-Mar-18,31-Mar-2018 To Comm.on NEFT:/IBKL-THESVCCO-OPER-004418090063534[ID:6,0,6,-61972737.2,-61972737.2,0,6,True,NEFT,39
31-03-2018,31-Mar-18,31-Mar-2018 To NEFT/IBKL-THE SVCCO-OPER-004418090063536[ID:63536],0,33000,-62005737.2,-62005737.2,0,33000,True,NEFT,39
31-03-2018,31-Mar-18,31-Mar-2018 To Comm.on NEFT:/IBKL-THESVCCO-OPER-004418090063536[ID:6,0,6,-62005743.2,-62005743.2,0,6,True,NEFT,39
31-03-2018,31-Mar-18,31-Mar-2018 To NEFT/IBKL-THE SVCCO-OPER-004418090063537[ID:63537],0,36200,-62041943.2,-62041943.2,0,36200,True,NEFT,39
31-03-2018,31-Mar-18,31-Mar-2018 To Comm.on NEFT:/IBKL-THESVCCO-OPER-004418090063537[ID:6,0,6,-62041949.2,-62041949.2,0,6,True,NEFT,39
31-03-2018,31-Mar-18,31-Mar-2018 To NEFT/IBKL-THE SVCCO-OPER-004418090063538[ID:63538],0,17800,-62059749.2,-62059749.2,0,17800,True,NEFT,39
31-03-2018,31-Mar-18,31-Mar-2018 To Comm.on NEFT:/IBKL-THESVCCO-OPER-004418090063538[ID:6,0,6,-62059755.2,-62059755.2,0,6,True,NEFT,39
31-03-2018,31-Mar-18,31-Mar-2018 To RTGS[ID:8771 For014102000012379 THE SVC COOPERATIVE BANK LTD],0,206493,-62266248.2,-62266248.2,0,206493,True,RTGS,39
31-03-2018,31-Mar-18,31-Mar-2018 To Comm. on RTGS[ID:8771 For014102000012379 THE SVC COOPERATIVE BANK LTD],0,35,-62266283.2,-62266283.2,0,35,True,RTGS,39
31-03-2018,31-Mar-18,31-Mar-2018 By NEFT/HDFC-GARDENREACH SH-N090180508248454[ID:63560],3079906.49,0,-59186376.71,-59186376.71,3079906.49,0,True,NEFT,39
31-03-2018,31-Mar-18,31-Mar-2018 To NEFT/IBKL-SVC COOPERATIV-004418090063572[ID:63572],0,1073837,-60260213.71,-60260213.71,0,1073837,True,NEFT,39
31-03-2018,31-Mar-18,31-Mar-2018 To Comm.on NEFT:/IBKL-SVCCOOPERATIV-004418090063572[ID:,0,29,-60260242.71,-60260242.71,0,29,True,NEFT,39
31-03-2018,31-Mar-18,31-Mar-2018 To NEFT/IBKL-SVC COOPERATVI-004418090063570[ID:63570],0,1038115,-61298357.71,-61298357.71,0,1038115,True,NEFT,39
31-03-2018,31-Mar-18,31-Mar-2018 To Comm.on NEFT:/IBKL-SVCCOOPERATVI-004418090063570[ID:,0,29,-61298386.71,-61298386.71,0,29,True,NEFT,39
31-03-2018,31-Mar-18,31-Mar-2018 To NEFT/IBKL-SVC COOPERATIV-004418090063569[ID:63569],0,2000000,-63298386.71,-63298386.71,0,2000000,True,NEFT,39
31-03-2018,31-Mar-18,31-Mar-2018 To Comm.on NEFT:/IBKL-SVCCOOPERATIV-004418090063569[ID:,0,29,-63298415.71,-63298415.71,0,29,True,NEFT,39
31-03-2018,31-Mar-18,31-Mar-2018 To Service Charges Charged onLC/No.22131-Mar-2018 To Service Charges Charged on,0,1180,-63299595.71,-63299595.71,0,1180,True,CHARGES,39
31-03-2018,31-Mar-18,31-Mar-2018 To Service Charges Charged onLC/No.22231-Mar-2018 To COMM ON LC ISSUED BY,0,1180,-63300775.71,-63300775.71,0,1180,True,CHARGES,39
31-03-2018,31-Mar-18,31-Mar-2018 To COMM ON LC ISSUED BYAXIS BANK Trupati Structur31-Mar-2018 To COMM ON LC ISSUED BY,0,35439.41,-63336215.12,-63336215.12,0,35439.4099999964,True,Others,39
31-03-2018,31-Mar-18,31-Mar-2018 To COMM ON LC ISSUED BYAXIS BANK METAL TUBESDate Particulars,0,5360.27,-63341575.39,-63341575.39,0,5360.27000000328,True,Others,39
31-03-2018,31-Mar-18,31-Mar-2018 To Int. Dr. 01/03/2018,0,777539,-64119114.39,-64119114.39,0,777539,True,Others,39
03-04-2018,03-Apr-18,By Opening Balance,0,0,-64119114.39,-64119114.39,0,0,True,Others,39
03-04-2018,03-Apr-18,To ACH DR KMBLDRAOPE,0,146889,-64266003.39,-64266003.39,0,146889,True,NACH,39
03-04-2018,03-Apr-18,To ACH DR TP ACH TAT,0,244816,-64510819.39,-64510819.39,0,244816,True,NACH,39
03-04-2018,03-Apr-18,BONFIGLIOLI TRANSMISSIONSPVT LTDHARI OM FABRICATORS,0,96988,-64607807.39,-64607807.39,0,96988,True,Others,39
03-04-2018,03-Apr-18,HARI OM FABRICATORS,0,100000,-64707807.39,-64707807.39,0,100000,True,Others,39
03-04-2018,03-Apr-18,To NEFT/UTIB-BHARATOXYTECH-004418093063720[ID:63720],0,126200,-64834007.39,-64834007.39,0,126200,True,NEFT,39
03-04-2018,03-Apr-18,To Comm.onNEFT:/UTIB-BHARAT OXYTECH-004418093063720[ID:63720],0,16,-64834023.39,-64834023.39,0,16,True,NEFT,39
04-04-2018,04-Apr-18,by o/w-229/2-berger paints indialtdby o/w-26/91-savita polymers ltd,2360000,0,-62474023.39,-62474023.39,2360000,0,True,OUTWARD,39
04-04-2018,04-Apr-18,by o/w-26/91-savita polymers ltd,70800,0,-62403223.39,-62403223.39,70800,0,True,OUTWARD,39
04-04-2018,04-Apr-18,To NEFT/PUNB-MAMTARAI-004418094063806[ID:63806]To Comm.on,0,99000,-62502223.39,-62502223.39,0,99000,True,NEFT,39
04-04-2018,04-Apr-18,To Comm.onNEFT:/PUNB-MAMTARAI-004418094063806[ID:63806],0,6,-62502229.39,-62502229.39,0,6,True,NEFT,39
04-04-2018,04-Apr-18,CSA FITTINGS,0,10266,-62512495.39,-62512495.39,0,10266,True,Others,39
04-04-2018,04-Apr-18,SURBHI SALES CORPORATION,0,63443,-62575938.39,-62575938.39,0,63443,True,Others,39
04-04-2018,04-Apr-18,TIRUPATI ELECTRICALS,0,23633,-62599571.39,-62599571.39,0,23633,True,Others,39
04-04-2018,04-Apr-18,S S ENGINEERING COMPANY,0,24839,-62624410.39,-62624410.39,0,24839,True,Others,39
04-04-2018,04-Apr-18,SHREE HARI OM DISHENDWORKSSPRAYFILL INDIA PRIVATE LTD,0,101132,-62725542.39,-62725542.39,0,101132,True,Others,39
04-04-2018,04-Apr-18,SPRAYFILL INDIA PRIVATE LTD,0,79214,-62804756.39,-62804756.39,0,79214,True,Others,39
04-04-2018,04-Apr-18,AMEYA SERVICES,0,2596,-62807352.39,-62807352.39,0,2596,True,Others,39
04-04-2018,04-Apr-18,MAA HOISTS AND CRANESSERVICESABDUL FABRICATOR,0,31565,-62838917.39,-62838917.39,0,31565,True,Others,39
04-04-2018,04-Apr-18,ABDUL FABRICATORParticularsTo ACH DR HDFC BANK,0,200000,-63038917.39,-63038917.39,0,200000,True,NACH,39
05-04-2018,05-Apr-18,To ACH DR HDFC BANK,0,19408,-63058325.39,-63058325.39,0,19408,True,NACH,39
05-04-2018,05-Apr-18,To ACH DR BDACH-RTBN,0,98440,-63156765.39,-63156765.39,0,98440,True,NACH,39
05-04-2018,05-Apr-18,To ACH DR IVL FINANC,0,179511,-63336276.39,-63336276.39,0,179511,True,NACH,39
05-04-2018,05-Apr-18,To NEFT/BARB-CHHATRASANBHAI-004418095063955[ID:63955],0,36162,-63372438.39,-63372438.39,0,36162,True,NEFT,39
05-04-2018,05-Apr-18,To Comm.onNEFT:/BARB-CHHATRASANBHAI-004418095063955[ID:63955,0,6,-63372444.39,-63372444.39,0,6,True,NEFT,39
05-04-2018,05-Apr-18,To NEFT/UTIB-SHAHANWAZALAM-004418095063959[ID:63959],0,15000,-63387444.39,-63387444.39,0,15000,True,NEFT,39
05-04-2018,05-Apr-18,To Comm.onNEFT:/UTIB-SHAHANWAZALAM-004418095063959[ID:6395,0,6,-63387450.39,-63387450.39,0,6,True,NEFT,39
05-04-2018,05-Apr-18,To ACH DR ADITY BIRL,0,203544,-63590994.39,-63590994.39,0,203544,True,NACH,39
05-04-2018,05-Apr-18,By RTGS ID:8797 [From140310000725BERGERAUTOANDINDUSTRIAL,1494997,0,-62095997.39,-62095997.39,1494997,0,True,RTGS,39
05-04-2018,05-Apr-18,B M COATS,0,103292,-62199289.39,-62199289.39,0,103292,True,Others,39
05-04-2018,05-Apr-18,NEW S K ROADWAYS,0,7000,-62206289.39,-62206289.39,0,7000,True,Others,39
05-04-2018,05-Apr-18,SHREE SAI INDUSTRIES,0,75114,-62281403.39,-62281403.39,0,75114,True,Others,39
05-04-2018,05-Apr-18,SHREE SHIV DISHEND WORKS,0,28314,-62309717.39,-62309717.39,0,28314,True,Others,39
05-04-2018,05-Apr-18,J K WASTE SUPPLIER,0,21888,-62331605.39,-62331605.39,0,21888,True,Others,39
05-04-2018,05-Apr-18,OM SAI ELECTRIC WORKS,0,84160,-62415765.39,-62415765.39,0,84160,True,Others,39
05-04-2018,05-Apr-18,SHUBHAM PAINTING ANDCONTRACTORSHREE SADANAND,0,50000,-62465765.39,-62465765.39,0,50000,True,Others,39
05-04-2018,05-Apr-18,SHREE SADANANDCONSTRUCTIONTo NEFT/IBKL-THE SVC CO,0,29569,-62495334.39,-62495334.39,0,29569,True,NEFT,39
05-04-2018,05-Apr-18,To NEFT/IBKL-THE SVC COOPER-004418095063988[ID:63988],0,187914,-62683248.39,-62683248.39,0,187914,True,NEFT,39
05-04-2018,05-Apr-18,To Comm.on NEFT:/IBKL-THESVC COOPER-004418095063988[ID:6398,0,16,-62683264.39,-62683264.39,0,16,True,NEFT,39
05-04-2018,05-Apr-18,To REALSIATION OF BILLNPI/TAL/018By Mrg,0,1423068,-64106332.39,-64106332.39,0,1423068,True,Others,39
05-04-2018,05-Apr-18,By MrgRev.GEN(BD)7/1172/HundiNo.NPI/TAL/0018,142306.8,0,-63964025.59,-63964025.59,142306.799999997,0,True,Others,39
05-04-2018,05-Apr-18,To Hundi No (NPI/TAL/0018),0,17404,-63981429.59,-63981429.59,0,17404,True,Others,39
05-04-2018,05-Apr-18,To STOCK AUDIT FEES FORJULY - DEC 2017Particulars,0,7430,-63988859.59,-63988859.59,0,7430,True,Others,39
05-04-2018,05-Apr-18,To PART COMM RECOVERREDON LC NO 216To PART COMM RECOVERRED,0,398,-63989257.59,-63989257.59,0,398,True,Others,39
05-04-2018,05-Apr-18,To PART COMM RECOVERREDON LC NO 217By RTGS ID:8800 From,0,1473,-63990730.59,-63990730.59,0,1473,True,RTGS,39
06-04-2018,06-Apr-18,By RTGS ID:8800 From24605053424M/S NOVATECHPROJECTS (I) PRIVATE,4500000,0,-59490730.59,-59490730.59,4500000,0,True,RTGS,39
06-04-2018,06-Apr-18,"To REALISATION OF GRE/005,BHEL-093NEXECUTIVE ENGINEER MIDC",0,4327833,-63818563.59,-63818563.59,0,4327833,True,Others,39
06-04-2018,06-Apr-18,NEXECUTIVE ENGINEER MIDC,0,4206,-63822769.59,-63822769.59,0,4206,True,Others,39
06-04-2018,06-Apr-18,NOORI INDUSTRIAL GASES,0,202806,-64025575.59,-64025575.59,0,202806,True,Others,39
06-04-2018,06-Apr-18,M K PRESSING WORKS,0,38668,-64064243.59,-64064243.59,0,38668,True,Others,39
06-04-2018,06-Apr-18,By MrgRev.GEN(BD)7/1177/HundiNo.BHEL/093,167137,0,-63897106.59,-63897106.59,167137,0,True,Others,39
06-04-2018,06-Apr-18,To Hundi No (BHEL/093),0,23635,-63920741.59,-63920741.59,0,23635,True,Others,39
06-04-2018,06-Apr-18,By MrgRev.GEN(BD)7/1179/HundiNo.GRSE/R-005,265646.3,0,-63655095.29,-63655095.29,265646.300000004,0,True,Others,39
06-04-2018,06-Apr-18,To Hundi No (GRSE/R-005),0,37565,-63692660.29,-63692660.29,0,37565,True,Others,39
06-04-2018,06-Apr-18,To Commission Charged onLC/No.223To Service Charges Charged on,0,8167,-63700827.29,-63700827.29,0,8167,True,CHARGES,39
06-04-2018,06-Apr-18,To Service Charges Charged onLC/No.223To LC/No.215 Ammendment,0,1180,-63702007.29,-63702007.29,0,1180,True,CHARGES,39
06-04-2018,06-Apr-18,To LC/No.215 AmmendmentChargesTo LC/No.209 Ammendment,0,1180,-63703187.29,-63703187.29,0,1180,True,CHARGES,39
06-04-2018,06-Apr-18,To LC/No.209 AmmendmentChargesTo NEFT/UTIB-AMOL,0,1180,-63704367.29,-63704367.29,0,1180,True,CHARGES,39
06-04-2018,06-Apr-18,To NEFT/UTIB-AMOLLAD-004418096064075[ID:64075]To Comm.on NEFT:/UTIB-AMOL,0,13752,-63718119.29,-63718119.29,0,13752,True,NEFT,39
06-04-2018,06-Apr-18,To Comm.on NEFT:/UTIB-AMOLLAD-004418096064075[ID:64075]By NEFT/BKDN-NOVATECH,0,6,-63718125.29,-63718125.29,0,6,True,NEFT,39
06-04-2018,06-Apr-18,By NEFT/BKDN-NOVATECHPROJEC-SDC82553393[ID:64085],6000000,0,-57718125.29,-57718125.29,6000000,0,True,NEFT,39
06-04-2018,06-Apr-18,"To REALISATION OF BILLSBGR-75, RAMGUNDAMTo NEFT/KKBK-SOUMADEEP",0,5114853,-62832978.29,-62832978.29,0,5114853,True,NEFT,39
06-04-2018,06-Apr-18,To NEFT/KKBK-SOUMADEEPSUKUM-004418096064092[ID:64092],0,47508,-62880486.29,-62880486.29,0,47508,True,NEFT,39
06-04-2018,06-Apr-18,To Comm.onNEFT:/KKBK-SOUMADEEPSUKUM-004418096064092[ID:64,0,6,-62880492.29,-62880492.29,0,6,True,NEFT,39
06-04-2018,06-Apr-18,By MrgRev.GEN(BD)7/1173/HundiNo.3628748,362874.8,0,-62517617.49,-62517617.49,362874.799999997,0,True,Others,39
06-04-2018,06-Apr-18,To Hundi No (3628748)ParticularsBy Mrg,0,48541,-62566158.49,-62566158.49,0,48541,True,Others,39
06-04-2018,06-Apr-18,By MrgRev.GEN(BD)7/1176/HundiNo.BGR/75M,148610.5,0,-62417547.99,-62417547.99,148610.5,0,True,Others,39
06-04-2018,06-Apr-18,To Hundi No (BGR/75M),0,18743,-62436290.99,-62436290.99,0,18743,True,Others,39
06-04-2018,06-Apr-18,By Transfer TD/FDS/2619,265090,0,-62171200.99,-62171200.99,265090,0,True,Others,39
07-04-2018,07-Apr-18,To DECS HDFC BANK46239223To ACH DR MAGMAFINCO,0,11900,-62183100.99,-62183100.99,0,11900,True,ECS,39
07-04-2018,07-Apr-18,To ACH DR MAGMAFINCO,0,121329,-62304429.99,-62304429.99,0,121329,True,NACH,39
07-04-2018,07-Apr-18,To ACH DR MAGMAFINCO,0,161578,-62466007.99,-62466007.99,0,161578,True,NACH,39
07-04-2018,07-Apr-18,OMCAR ENGINEERING WORKS,0,19597,-62485604.99,-62485604.99,0,19597,True,Others,39
07-04-2018,07-Apr-18,FALAK ENGINEERING WORKS,0,101970,-62587574.99,-62587574.99,0,101970,True,Others,39
07-04-2018,07-Apr-18,SHREE VISHWAKARMAENTERPRISESBy Disc. GEN(BD)7/Hundi,0,26184,-62613758.99,-62613758.99,0,26184,True,Others,39
07-04-2018,07-Apr-18,By Disc. GEN(BD)7/HundiNo.AMB/58/17-18To Disc. GEN(BD)7/Hundi,3581395.2,0,-59032363.79,-59032363.79,3581395.2,0,True,Others,39
07-04-2018,07-Apr-18,To Disc. GEN(BD)7/HundiNo.AMB/58/17-18By Disc. GEN(BD)7/Hundi,0,29142,-59061505.79,-59061505.79,0,29142,True,Others,39
07-04-2018,07-Apr-18,By Disc. GEN(BD)7/HundiNo.AMB/61/17-18To Disc. GEN(BD)7/Hundi,3334999.5,0,-55726506.29,-55726506.29,3334999.5,0,True,Others,39
07-04-2018,7-Apr-18,To Disc. GEN(BD)7/HundiNo.AMB/61/17-18By Disc. GEN(BD)7/Hundi,0,34172,-55760678.29,-55760678.29,0,34172,True,Others,39
07-04-2018,7-Apr-18,By Disc. GEN(BD)7/HundiNo.TAL/0032To Disc. GEN(BD)7/Hundi,2681550,0,-53079128.29,-53079128.29,2681550,0,True,Others,39
07-04-2018,7-Apr-18,To Disc. GEN(BD)7/HundiNo.TAL/0032To LC-No 188 Retired,0,67075,-53146203.29,-53146203.29,0,67075,True,Others,39
09-04-2018,9-Apr-18,To LC-No 188 Retired,0,844799,-53991002.29,-53991002.29,0,844799,True,Others,39
09-04-2018,9-Apr-18,To INT @ 9% FOR 90 DAYS ONLC NO 188 BV STEEL CORPNEW AGE INDUSTRIES,0,18748,-54009750.29,-54009750.29,0,18748,True,Others,39
09-04-2018,9-Apr-18,NEW AGE INDUSTRIES,0,11470,-54021220.29,-54021220.29,0,11470,True,Others,39
09-04-2018,9-Apr-18,EASTWEST ENGINEERING ANDELECTRONICS PVT LTDTo NEFT/IBKL-SVC CO,0,12980,-54034200.29,-54034200.29,0,12980,True,NEFT,39
09-04-2018,9-Apr-18,To NEFT/IBKL-SVC COOPERATIV-004418099064235[ID:64235],0,60109,-54094309.29,-54094309.29,0,60109,True,NEFT,39
09-04-2018,9-Apr-18,To Comm.on NEFT:/IBKL-SVCCOOPERATIV-004418099064235[ID:,0,6,-54094315.29,-54094315.29,0,6,True,NEFT,39
09-04-2018,9-Apr-18,To NEFT/IBKL-SVC COOPERATIV-004418099064236[ID:64236],0,5667,-54099982.29,-54099982.29,0,5667,True,NEFT,39
09-04-2018,9-Apr-18,To Comm.on NEFT:/IBKL-SVCCOOPERATIV-004418099064236[ID:,0,3,-54099985.29,-54099985.29,0,3,True,NEFT,39
09-04-2018,9-Apr-18,To NEFT/IBKL-SVC COOPERATIV-004418099064237[ID:64237],0,300,-54100285.29,-54100285.29,0,300,True,NEFT,39
09-04-2018,9-Apr-18,To Comm.on NEFT:/IBKL-SVCCOOPERATIV-004418099064237[ID:,0,3,-54100288.29,-54100288.29,0,3,True,NEFT,39
09-04-2018,9-Apr-18,By NEFT ID:64250 [From RAREFUND POOL ACCOUNT]OM SHIV JAGRUTI CANTEEN,19408,0,-54080880.29,-54080880.29,19408,0,True,NEFT,39
10-04-2018,10-Apr-18,OM SHIV JAGRUTI CANTEEN,0,16358,-54097238.29,-54097238.29,0,16358,True,Others,39
10-04-2018,10-Apr-18,H J PATIL,0,26235,-54123473.29,-54123473.29,0,26235,True,Others,39
10-04-2018,10-Apr-18,OM GASES AND CHEMICALS,0,137635,-54261108.29,-54261108.29,0,137635,True,Others,39
10-04-2018,10-Apr-18,SANJOG EQUIPMENTS PVTLTDTo NEFT/SCBL-NOIVATECH,0,188500,-54449608.29,-54449608.29,0,188500,True,NEFT,39
10-04-2018,10-Apr-18,To NEFT/SCBL-NOIVATECHPROJE-004418100064330[ID:64330],0,1400000,-55849608.29,-55849608.29,0,1400000,True,NEFT,39
10-04-2018,10-Apr-18,To Comm.onNEFT:/SCBL-NOIVATECHPROJE-004418100064330[ID:643,0,29,-55849637.29,-55849637.29,0,29,True,NEFT,39
10-04-2018,10-Apr-18,To NEFT/BKDN-NOVATECHPROJEC-004418100064332[ID:64332],0,4200000,-60049637.29,-60049637.29,0,4200000,True,NEFT,39
10-04-2018,10-Apr-18,To Comm.onNEFT:/BKDN-NOVATECHPROJEC-004418100064332[ID:64,0,29,-60049666.29,-60049666.29,0,29,True,NEFT,39
10-04-2018,10-Apr-18,To NEFT/IBKL-SVC COOPERATIV-004418100064356[ID:64356],0,747,-60050413.29,-60050413.29,0,747,True,NEFT,39
10-04-2018,10-Apr-18,To Comm.on NEFT:/IBKL-SVCCOOPERATIV-004418100064356[ID:,0,3,-60050416.29,-60050416.29,0,3,True,NEFT,39
11-04-2018,11-Apr-18,To SI TL/B-LOAN/149,0,101876,-60152292.29,-60152292.29,0,101876,True,ECS,39
11-04-2018,11-Apr-18,R S ENGINEERING,0,8712,-60161004.29,-60161004.29,0,8712,True,Others,39
11-04-2018,11-Apr-18,VKONNECT TOURS ANDTRAVELS PVT LTDSHRAVAN VISHWAKARMA,0,38248,-60199252.29,-60199252.29,0,38248,True,Others,39
11-04-2018,11-Apr-18,SHRAVAN VISHWAKARMA,0,8740,-60207992.29,-60207992.29,0,8740,True,Others,39
11-04-2018,11-Apr-18,To NEFT/IBKL-SVC COOPERATIV-004418101064434[ID:64434],0,174786,-60382778.29,-60382778.29,0,174786,True,NEFT,39
11-04-2018,11-Apr-18,To Comm.on NEFT:/IBKL-SVCCOOPERATIV-004418101064434[ID:,0,16,-60382794.29,-60382794.29,0,16,True,NEFT,39
11-04-2018,11-Apr-18,To NEFT/IBKL-SVC COOPERATIV-004418101064429[ID:64429],0,180553,-60563347.29,-60563347.29,0,180553,True,NEFT,39
11-04-2018,11-Apr-18,To Comm.on NEFT:/IBKL-SVCCOOPERATIV-004418101064429[ID:,0,16,-60563363.29,-60563363.29,0,16,True,NEFT,39
11-04-2018,11-Apr-18,To NEFT/IBKL-SVC COOPERATIV-004418101064427[ID:64427],0,80998,-60644361.29,-60644361.29,0,80998,True,NEFT,39
11-04-2018,11-Apr-18,To Comm.on NEFT:/IBKL-SVCCOOPERATIV-004418101064427[ID:,0,6,-60644367.29,-60644367.29,0,6,True,NEFT,39
11-04-2018,11-Apr-18,To RTGS[ID:8825 For014102000012379 SVC COOPERATIVE BANK LTD],0,204366,-60848733.29,-60848733.29,0,204366,True,RTGS,39
11-04-2018,11-Apr-18,To Comm. on RTGS[ID:8825 For014102000012379 SVC COOPERATIVE BANK LTD],0,35,-60848768.29,-60848768.29,0,35,True,RTGS,39
11-04-2018,11-Apr-18,To RTGS[ID:8826 For014102000012379 SVC COOPERATIVE BANK LTD],0,229982,-61078750.29,-61078750.29,0,229982,True,RTGS,39
11-04-2018,11-Apr-18,To Comm. on RTGS[ID:8826 For014102000012379 SVC COOPERATIVE BANK LTD],0,35,-61078785.29,-61078785.29,0,35,True,RTGS,39
11-04-2018,11-Apr-18,To NEFT/UTIB-AKSHAYMEHRA-004418101064424[ID:64424],0,19532,-61098317.29,-61098317.29,0,19532,True,NEFT,39
11-04-2018,11-Apr-18,To Comm.onNEFT:/UTIB-AKSHAYMEHRA-004418101064424[ID:64,0,6,-61098323.29,-61098323.29,0,6,True,NEFT,39
11-04-2018,11-Apr-18,To NEFT/UTIB-DIPAKGHOSH-004418101064423[ID:64423],0,100000,-61198323.29,-61198323.29,0,100000,True,NEFT,39
11-04-2018,11-Apr-18,To Comm.on NEFT:/UTIB-DIPAKGHOSH-004418101064423[ID:64423],0,6,-61198329.29,-61198329.29,0,6,True,NEFT,39
11-04-2018,11-Apr-18,To NEFT/HDFC-INDUSTRIALGAS-004418101064421[ID:64421],0,100000,-61298329.29,-61298329.29,0,100000,True,NEFT,39
11-04-2018,11-Apr-18,To Comm.onNEFT:/HDFC-INDUSTRIAL GAS-004418101064421[ID:64421],0,6,-61298335.29,-61298335.29,0,6,True,NEFT,39
11-04-2018,11-Apr-18,To ROC CHARGE OF VEHICLELOAN 7.00 LACSTo LC-No 172 Retired,0,8960,-61307295.29,-61307295.29,0,8960,True,CHARGES,39
12-04-2018,12-Apr-18,To LC-No 172 Retired,0,1582773,-62890068.29,-62890068.29,0,1582773,True,Others,39
12-04-2018,12-Apr-18,To Self,0,25000,-62915068.29,-62915068.29,0,25000,True,CASH,39
12-04-2018,12-Apr-18,To NEFT/UTIB-SHAHANWAZALAM-004418102064512[ID:64512],0,25000,-62940068.29,-62940068.29,0,25000,True,NEFT,39
12-04-2018,12-Apr-18,To Comm.onNEFT:/UTIB-SHAHANWAZALAM-004418102064512[ID:6451,0,6,-62940074.29,-62940074.29,0,6,True,NEFT,39
12-04-2018,12-Apr-18,To RTGS[ID:8828 For 0112396848INESH ACCERRO LTD]To Comm. on RTGS[ID:8828 For,0,1000000,-63940074.29,-63940074.29,0,1000000,True,RTGS,39
12-04-2018,12-Apr-18,To Comm. on RTGS[ID:8828 For0112396848 INESH ACCERROLTD],0,60,-63940134.29,-63940134.29,0,60,True,RTGS,39
12-04-2018,12-Apr-18,EXECUTIVE ENGINEER MIDCParticularsEXECUTIVE ENGINEER MIDC,0,3639,-63943773.29,-63943773.29,0,3639,True,Others,39
12-04-2018,12-Apr-18,EXECUTIVE ENGINEER MIDC,0,1562,-63945335.29,-63945335.29,0,1562,True,Others,39
12-04-2018,12-Apr-18,OM LIFTERS,0,131320,-64076655.29,-64076655.29,0,131320,True,Others,39
12-04-2018,12-Apr-18,EXECUTIVE ENGINEER MIDC,0,3786,-64080441.29,-64080441.29,0,3786,True,Others,39
12-04-2018,12-Apr-18,To PART COMM ON LC NO 188,0,83,-64080524.29,-64080524.29,0,83,True,Others,39
12-04-2018,12-Apr-18,To PART COMM ON LC NO 189,0,747,-64081271.29,-64081271.29,0,747,True,Others,39
13-04-2018,13-Apr-18,To NEFT/UTIB-AMOLLAD-004418103064593[ID:64593]To Comm.on NEFT:/UTIB-AMOL,0,10000,-64091271.29,-64091271.29,0,10000,True,NEFT,39
13-04-2018,13-Apr-18,To Comm.on NEFT:/UTIB-AMOLLAD-004418103064593[ID:64593]DRILLTECH ENTERPRISES,0,3,-64091274.29,-64091274.29,0,3,True,NEFT,39
13-04-2018,13-Apr-18,DRILLTECH ENTERPRISES,0,250000,-64341274.29,-64341274.29,0,250000,True,Others,39
13-04-2018,13-Apr-18,SHUBH STATIONERY ANDXEROXTo SI TL/B-LOAN/187,0,28025,-64369299.29,-64369299.29,0,28025,True,ECS,39
16-04-2018,16-Apr-18,To SI TL/B-LOAN/187,0,35700,-64404999.29,-64404999.29,0,35700,True,ECS,39
16-04-2018,16-Apr-18,To DECS TP-ICICI B1444583326To NEFT/UTIB-SHAHANWAZ,0,13680,-64418679.29,-64418679.29,0,13680,True,NEFT,39
16-04-2018,16-Apr-18,To NEFT/UTIB-SHAHANWAZALAM-004418106064706[ID:64706],0,21000,-64439679.29,-64439679.29,0,21000,True,NEFT,39
16-04-2018,16-Apr-18,To Comm.onNEFT:/UTIB-SHAHANWAZALAM-004418106064706[ID:6470,0,6,-64439685.29,-64439685.29,0,6,True,NEFT,39
16-04-2018,16-Apr-18,BALAJI INFOTECH INDUSTRIALPREMISES CO OP SOC LTDN K ENGINEERS,0,12771,-64452456.29,-64452456.29,0,12771,True,Others,39
17-04-2018,17-Apr-18,N K ENGINEERS,0,37120,-64489576.29,-64489576.29,0,37120,True,Others,39
17-04-2018,17-Apr-18,SHAH BROTHERS ISPAT PVTLTDSHREE SHYAM ROAD,0,16247,-64505823.29,-64505823.29,0,16247,True,Others,39
17-04-2018,17-Apr-18,SHREE SHYAM ROADTRANSPORT COTo NEFT/SIBL-SUNPOWER,0,173300,-64679123.29,-64679123.29,0,173300,True,NEFT,39
17-04-2018,17-Apr-18,To NEFT/SIBL-SUNPOWERTRADIN-004418107064801[ID:64801],0,88000,-64767123.29,-64767123.29,0,88000,True,NEFT,39
17-04-2018,17-Apr-18,To Comm.onNEFT:/SIBL-SUNPOWERTRADIN-004418107064801[ID:648,0,6,-64767129.29,-64767129.29,0,6,True,NEFT,39
18-04-2018,18-Apr-18,To NEFT/UTIB-SHAHANWAZALAM-004418108064866[ID:64866],0,25000,-64792129.29,-64792129.29,0,25000,True,NEFT,39
18-04-2018,18-Apr-18,To Comm.onNEFT:/UTIB-SHAHANWAZALAM-004418108064866[ID:6486,0,6,-64792135.29,-64792135.29,0,6,True,NEFT,39
18-04-2018,18-Apr-18,By RTGS ID:8872 [From226902000000437 CULMINATINGPROJECT PVT LTD 4 K K,1800000,0,-62992135.29,-62992135.29,1800000,0,True,RTGS,39
18-04-2018,18-Apr-18,To RTGS[ID:8878 For0157083000001562 SUNPOWERTRADING PVT LTD],0,1672067,-64664202.29,-64664202.29,0,1672067,True,RTGS,39
18-04-2018,18-Apr-18,To Comm. on RTGS[ID:8878 For0157083000001562 SUNPOWERTRADING PVT LTD],0,64,-64664266.29,-64664266.29,0,64,True,RTGS,39
18-04-2018,18-Apr-18,To Commission Charged onLC/No.226To Service Charges Charged on,0,35402,-64699668.29,-64699668.29,0,35402,True,CHARGES,39
18-04-2018,18-Apr-18,To Service Charges Charged onLC/No.226To NEFT/SIBL-SUNPOWER,0,1180,-64700848.29,-64700848.29,0,1180,True,CHARGES,39
18-04-2018,18-Apr-18,To NEFT/SIBL-SUNPOWERTRADIN-004418108064912[ID:64912],0,173000,-64873848.29,-64873848.29,0,173000,True,NEFT,39
18-04-2018,18-Apr-18,To Comm.onNEFT:/SIBL-SUNPOWERTRADIN-004418108064912[ID:649,0,16,-64873864.29,-64873864.29,0,16,True,NEFT,39
19-04-2018,19-Apr-18,RESHMA CATERERS,0,1275,-64875139.29,-64875139.29,0,1275,True,Others,39
19-04-2018,19-Apr-18,By RTGS ID:8885 From24605053424M/S NOVATECHPROJECTS (I) PRIVATE,4000000,0,-60875139.29,-60875139.29,4000000,0,True,RTGS,39
19-04-2018,19-Apr-18,"To REAL OF BILLSBERGER/19,20, BHEL/113By Mrg",0,3629357,-64504496.29,-64504496.29,0,3629357,True,Others,39
19-04-2018,19-Apr-18,By MrgRev.GEN(BD)7/1174/HundiNo.BERGER/0019,149572,0,-64354924.29,-64354924.29,149572,0,True,Others,39
19-04-2018,19-Apr-18,To Hundi No (BERGER/0019),0,22294,-64377218.29,-64377218.29,0,22294,True,Others,39
19-04-2018,19-Apr-18,By MrgRev.GEN(BD)7/1175/HundiNo.BERGER/0020,125176.6,0,-64252041.69,-64252041.69,125176.600000002,0,True,Others,39
19-04-2018,19-Apr-18,To Hundi No (BERGER/0020),0,18658,-64270699.69,-64270699.69,0,18658,True,Others,39
19-04-2018,19-Apr-18,By MrgRev.GEN(BD)7/1181/HundiNo.BHEL/113,88187.1,0,-64182512.59,-64182512.59,88187.099999994,0,True,Others,39
19-04-2018,19-Apr-18,To Hundi No (BHEL/113),0,1827,-64184339.59,-64184339.59,0,1827,True,Others,39
19-04-2018,19-Apr-18,By NEFT/SBIN-RAMAGUNDAMFERT-SBIN318109058506[ID:64994],4551966,0,-59632373.59,-59632373.59,4551966,0,True,NEFT,39
20-04-2018,20-Apr-18,To NEFT/HDFC-DESHMUKHENGGC-004418110065030[ID:65030],0,5400,-59637773.59,-59637773.59,0,5400,True,NEFT,39
20-04-2018,20-Apr-18,To Comm.onNEFT:/HDFC-DESHMUKH ENGGC-004418110065030[ID:65030],0,3,-59637776.59,-59637776.59,0,3,True,NEFT,39
20-04-2018,20-Apr-18,By NEFT ID:65034 [FromBHAVYA STEELSALLOYS PVTLTD],169212,0,-59468564.59,-59468564.59,169212,0,True,NEFT,39
20-04-2018,20-Apr-18,To NEFT/UTIB-SANDEEPSAXENA-004418110065035[ID:65035],0,15000,-59483564.59,-59483564.59,0,15000,True,NEFT,39
20-04-2018,20-Apr-18,To Comm.onNEFT:/UTIB-SANDEEPSAXENA-004418110065035[ID:65,0,6,-59483570.59,-59483570.59,0,6,True,NEFT,39
20-04-2018,20-Apr-18,SHREE SHYAM TRAILORSERVICESSHREEJI ENTERPRISES,0,9000,-59492570.59,-59492570.59,0,9000,True,Others,39
20-04-2018,20-Apr-18,SHREEJI ENTERPRISES,0,5074,-59497644.59,-59497644.59,0,5074,True,Others,39
20-04-2018,20-Apr-18,SPENTA GASKETS AND SEAL,0,33040,-59530684.59,-59530684.59,0,33040,True,Others,39
20-04-2018,20-Apr-18,By RTGS ID:8887 From24605053424M/S NOVATECHPROJECTS (I) PRIVATE,3000000,0,-56530684.59,-56530684.59,3000000,0,True,RTGS,39
20-04-2018,20-Apr-18,To REALISATION OF BILLS -NPI/AMB/0043 & BHEL/112By Mrg,0,8042047,-64572731.59,-64572731.59,0,8042047,True,Others,39
20-04-2018,20-Apr-18,By MrgRev.GEN(BD)7/1178/HundiNo.NPI/AMB/0043,728918,0,-63843813.59,-63843813.59,728918,0,True,Others,39
20-04-2018,20-Apr-18,To Hundi No (NPI/AMB/0043),0,128150,-63971963.59,-63971963.59,0,128150,True,Others,39
20-04-2018,20-Apr-18,By MrgRev.GEN(BD)7/1180/HundiNo.BHEL/112,75286.7,0,-63896676.89,-63896676.89,75286.700000003,0,True,Others,39
20-04-2018,20-Apr-18,To Hundi No (BHEL/112),0,1819,-63898495.89,-63898495.89,0,1819,True,Others,39
20-04-2018,20-Apr-18,To Commission Charged onLC/No.227To Service Charges Charged on,0,8929,-63907424.89,-63907424.89,0,8929,True,CHARGES,39
20-04-2018,20-Apr-18,To Service Charges Charged onLC/No.227By Disc. GEN(BD)7/Hundi,0,1180,-63908604.89,-63908604.89,0,1180,True,CHARGES,39
20-04-2018,20-Apr-18,By Disc. GEN(BD)7/HundiNo.GACL/73To Disc. GEN(BD)7/Hundi,2957968.8,0,-60950636.09,-60950636.09,2957968.8,0,True,Others,39
20-04-2018,20-Apr-18,To Disc. GEN(BD)7/HundiNo.GACL/73By Disc. GEN(BD)7/Hundi,0,52595,-61003231.09,-61003231.09,0,52595,True,Others,39
20-04-2018,20-Apr-18,By Disc. GEN(BD)7/HundiNo.BERGER/31To Disc. GEN(BD)7/Hundi,3026700,0,-57976531.09,-57976531.09,3026700,0,True,Others,39
20-04-2018,20-Apr-18,To Disc. GEN(BD)7/HundiNo.BERGER/31By Disc. GEN(BD)7/Hundi,0,63851,-58040382.09,-58040382.09,0,63851,True,Others,39
20-04-2018,20-Apr-18,By Disc. GEN(BD)7/HundiNo.BERGER/TAL/001To Disc. GEN(BD)7/Hundi,4570461.18,0,-53469920.91,-53469920.91,4570461.18000001,0,True,Others,39
20-04-2018,20-Apr-18,To Disc. GEN(BD)7/HundiNo.BERGER/TAL/001To NEFT/SCBL-NOVATECH,0,107437,-53577357.91,-53577357.91,0,107437,True,NEFT,39
20-04-2018,20-Apr-18,To NEFT/SCBL-NOVATECHPROJEC-004418110065066[ID:65066],0,3500000,-57077357.91,-57077357.91,0,3500000,True,NEFT,39
20-04-2018,20-Apr-18,To Comm.onNEFT:/SCBL-NOVATECHPROJEC-004418110065066[ID:65,0,29,-57077386.91,-57077386.91,0,29,True,NEFT,39
21-04-2018,21-Apr-18,To LC-No 172 Retired,0,435231,-57512617.91,-57512617.91,0,435231,True,Others,39
21-04-2018,21-Apr-18,To RTGS[ID:8892 For 0112396848INESH ACCERRO LTD]To Comm. on RTGS[ID:8892 For,0,1000000,-58512617.91,-58512617.91,0,1000000,True,RTGS,39
21-04-2018,21-Apr-18,To Comm. on RTGS[ID:8892 For0112396848 INESH ACCERROLTD],0,60,-58512677.91,-58512677.91,0,60,True,RTGS,39
21-04-2018,21-Apr-18,To RTGS[ID:8896 For32343227367 NOVATECHPROJECTS I PVT LTD],0,400000,-58912677.91,-58912677.91,0,400000,True,RTGS,39
21-04-2018,21-Apr-18,To Comm. on RTGS[ID:8896 For32343227367 NOVATECHPROJECTS I PVT LTD],0,32,-58912709.91,-58912709.91,0,32,True,RTGS,39
21-04-2018,21-Apr-18,To RTGS[ID:8893 For10150400000008 OMCONSULTING SERVICES],0,2338377,-61251086.91,-61251086.91,0,2338377,True,RTGS,39
21-04-2018,21-Apr-18,To Comm. on RTGS[ID:8893 For10150400000008 OMCONSULTING SERVICES],0,60,-61251146.91,-61251146.91,0,60,True,RTGS,39
21-04-2018,21-Apr-18,By RTGS ID:8898 [From021105500377 MANISHAENTERPRISE 209THE SUMMIT,834654,0,-60416492.91,-60416492.91,834654,0,True,RTGS,39
21-04-2018,21-Apr-18,To RTGS[ID:8895 For607705040000103 HALDERENTERPRISE],0,400000,-60816492.91,-60816492.91,0,400000,True,RTGS,39
21-04-2018,21-Apr-18,To Comm. on RTGS[ID:8895 For607705040000103 HALDERENTERPRISE],0,32,-60816524.91,-60816524.91,0,32,True,RTGS,39
21-04-2018,21-Apr-18,By RTGS ID:8899 [From021105500377 MANISHAENTERPRISE 209THE SUMMIT,813800,0,-60002724.91,-60002724.91,813800,0,True,RTGS,39
21-04-2018,21-Apr-18,By RTGS ID:8900 [From021105500377 MANISHAENTERPRISE 209THE SUMMIT,759068,0,-59243656.91,-59243656.91,759068,0,True,RTGS,39
21-04-2018,21-Apr-18,By RTGS ID:8901 [From021105500377 MANISHAENTERPRISE 209THE SUMMIT,527258,0,-58716398.91,-58716398.91,527258,0,True,RTGS,39
21-04-2018,21-Apr-18,To RTGS[ID:8902 For32343227367 NOVATECHPROJECTS I PVT LTD],0,200000,-58916398.91,-58916398.91,0,200000,True,RTGS,39
21-04-2018,21-Apr-18,To Comm. on RTGS[ID:8902 For32343227367 NOVATECHPROJECTS I PVT LTD],0,35,-58916433.91,-58916433.91,0,35,True,RTGS,39
21-04-2018,21-Apr-18,To RTGS[ID:8903 For00600310013437 ACC LTD]To Comm. on RTGS[ID:8903 For,0,337500,-59253933.91,-59253933.91,0,337500,True,RTGS,39
21-04-2018,21-Apr-18,To Comm. on RTGS[ID:8903 For00600310013437 ACC LTD]To NEFT/UBIN-JAY LAXMI,0,35,-59253968.91,-59253968.91,0,35,True,RTGS,39
21-04-2018,21-Apr-18,To NEFT/UBIN-JAY LAXMIFABRI-004418111065099[ID:65099],0,181613,-59435581.91,-59435581.91,0,181613,True,NEFT,39
21-04-2018,21-Apr-18,To Comm.on NEFT:/UBIN-JAYLAXMIFABRI-004418111065099[ID:6509,0,16,-59435597.91,-59435597.91,0,16,True,NEFT,39
21-04-2018,21-Apr-18,To NEFT/UTIB-SOURAVSARANGI-004418111065094[ID:65094],0,35420,-59471017.91,-59471017.91,0,35420,True,NEFT,39
21-04-2018,21-Apr-18,To Comm.onNEFT:/UTIB-SOURAVSARANGI-004418111065094[ID:6,0,6,-59471023.91,-59471023.91,0,6,True,NEFT,39
21-04-2018,21-Apr-18,To NEFT/IBKL-MAA TARADEVIBU-004418111065093[ID:65093]To Comm.on NEFT:/IBKL-MAA,0,150000,-59621023.91,-59621023.91,0,150000,True,NEFT,39
21-04-2018,21-Apr-18,To Comm.on NEFT:/IBKL-MAATARADEVIBU-004418111065093[ID:65093],0,16,-59621039.91,-59621039.91,0,16,True,NEFT,39
21-04-2018,21-Apr-18,To RTGS[ID:8906 For 0112396848INESH ACCERRO LTD]To Comm. on RTGS[ID:8906 For,0,1500000,-61121039.91,-61121039.91,0,1500000,True,RTGS,39
21-04-2018,21-Apr-18,To Comm. on RTGS[ID:8906 For0112396848 INESH ACCERROLTD],0,64,-61121103.91,-61121103.91,0,64,True,RTGS,39
21-04-2018,21-Apr-18,To RTGS[ID:8905 For1756002100016951 OSIA EXIMPVT LTD],0,3020900,-64142003.91,-64142003.91,0,3020900,True,RTGS,39
21-04-2018,21-Apr-18,To Comm. on RTGS[ID:8905 For1756002100016951 OSIA EXIMPVT LTD],0,64,-64142067.91,-64142067.91,0,64,True,RTGS,39
21-04-2018,21-Apr-18,To PO EXECUTIVE ENGG MIDC(4 PO'S)To PO No. Issued.,0,12007,-64154074.91,-64154074.91,0,12007,True,Others,39
21-04-2018,21-Apr-18,To PO No. Issued.,0,46880,-64200954.91,-64200954.91,0,46880,True,Others,39
21-04-2018,21-Apr-18,To PO COMM - EXECUTIVEENGG-MIDC(4PO'S)To NEFT/BKDN-JAGAT BANDHU,0,300,-64201254.91,-64201254.91,0,300,True,NEFT,39
21-04-2018,21-Apr-18,To NEFT/BKDN-JAGAT BANDHUDE-004418111065125[ID:65125]To Comm.on,0,63651,-64264905.91,-64264905.91,0,63651,True,NEFT,39
21-04-2018,21-Apr-18,To Comm.onNEFT:/BKDN-JAGAT BANDHUDE-004418111065125[ID:65125],0,6,-64264911.91,-64264911.91,0,6,True,NEFT,39
21-04-2018,21-Apr-18,To PO COMM - MSEDCL,0,141,-64265052.91,-64265052.91,0,141,True,Others,39
21-04-2018,21-Apr-18,To COMM ON LC NO 209,0,365,-64265417.91,-64265417.91,0,365,True,Others,39
21-04-2018,21-Apr-18,To COMM ON LC NO 210,0,179,-64265596.91,-64265596.91,0,179,True,Others,39
21-04-2018,21-Apr-18,To COMM ON LC NO 215,0,372,-64265968.91,-64265968.91,0,372,True,Others,39
21-04-2018,21-Apr-18,To COMM ON LC NO 226,0,1164,-64267132.91,-64267132.91,0,1164,True,Others,39
23-04-2018,23-Apr-18,RANU GAS SERVICE,0,3546,-64270678.91,-64270678.91,0,3546,True,Others,39
23-04-2018,23-Apr-18,VENUS ENGINEERS,0,126126,-64396804.91,-64396804.91,0,126126,True,Others,39
24-04-2018,24-Apr-18,To NEFT/BARB-SUMANA AVIJITG-004418114065209[ID:65209]To Comm.on,0,13277,-64410081.91,-64410081.91,0,13277,True,NEFT,39
24-04-2018,24-Apr-18,To Comm.onNEFT:/BARB-SUMANA AVIJITG-004418114065209[ID:65209],0,6,-64410087.91,-64410087.91,0,6,True,NEFT,39
24-04-2018,24-Apr-18,To Self,0,25000,-64435087.91,-64435087.91,0,25000,True,CASH,39
24-04-2018,24-Apr-18,By NEFT ID:65224 [FromRAMAGUNDAM FERTILIZERSAND],879945,0,-63555142.91,-63555142.91,879945,0,True,NEFT,39
24-04-2018,24-Apr-18,DEORAO B BATKI,0,23700,-63578842.91,-63578842.91,0,23700,True,Others,39
24-04-2018,24-Apr-18,VKONNECT TOURS ANDTRAVELS PVT LTDParticulars,0,50969,-63629811.91,-63629811.91,0,50969,True,Others,39
24-04-2018,24-Apr-18,NAVDA SERVICE STATION,0,10000,-63639811.91,-63639811.91,0,10000,True,Others,39
24-04-2018,24-Apr-18,To NEFT/YESB-PASSIMENGINEER-004418114065238[ID:65238],0,100000,-63739811.91,-63739811.91,0,100000,True,NEFT,39
24-04-2018,24-Apr-18,To Comm.onNEFT:/YESB-PASSIMENGINEER-004418114065238[ID:,0,6,-63739817.91,-63739817.91,0,6,True,NEFT,39
24-04-2018,24-Apr-18,To NEFT/UTIB-SHAHANWAZALAM-004418114065242[ID:65242],0,13500,-63753317.91,-63753317.91,0,13500,True,NEFT,39
24-04-2018,24-Apr-18,To Comm.onNEFT:/UTIB-SHAHANWAZALAM-004418114065242[ID:6524,0,6,-63753323.91,-63753323.91,0,6,True,NEFT,39
24-04-2018,24-Apr-18,To RTGS[ID:8921 For020150050801203 MAHARACONSTRUCTION],0,462560,-64215883.91,-64215883.91,0,462560,True,RTGS,39
24-04-2018,24-Apr-18,To Comm. on RTGS[ID:8921 For020150050801203 MAHARACONSTRUCTION],0,35,-64215918.91,-64215918.91,0,35,True,RTGS,39
24-04-2018,24-Apr-18,To Stop Pmt.(26419-26419),0,150,-64216068.91,-64216068.91,0,150,True,Others,39
24-04-2018,24-Apr-18,To NEFT/HDFC-U KBHOL-004418114065253[ID:65253],0,79271,-64295339.91,-64295339.91,0,79271,True,NEFT,39
24-04-2018,24-Apr-18,To Comm.on NEFT:/HDFC-U KBHOL-004418114065253[ID:65253],0,6,-64295345.91,-64295345.91,0,6,True,NEFT,39
24-04-2018,24-Apr-18,To NEFT/UTIB-TILAKARUN-004418114065252[ID:65252],0,50000,-64345345.91,-64345345.91,0,50000,True,NEFT,39
24-04-2018,24-Apr-18,To Comm.on NEFT:/UTIB-TILAKARUN-004418114065252[ID:65252],0,6,-64345351.91,-64345351.91,0,6,True,NEFT,39
25-04-2018,25-Apr-18,MSEDCL,0,36570,-64381921.91,-64381921.91,0,36570,True,Others,39
25-04-2018,25-Apr-18,INDO THERM ENGINEERS PVTLTDSAI SAGAR ENTERPRISES,0,220256,-64602177.91,-64602177.91,0,220256,True,Others,39
25-04-2018,25-Apr-18,SAI SAGAR ENTERPRISES,0,201960,-64804137.91,-64804137.91,0,201960,True,Others,39
25-04-2018,25-Apr-18,CHANDA ENGINEERINGWORKSTo PROCESSING CHRGS FR,0,8142,-64812279.91,-64812279.91,0,8142,True,CHARGES,39
25-04-2018,25-Apr-18,To PROCESSING CHRGS FRADHOC LIMIT OF RS 200LAKHS,0,23600,-64835879.91,-64835879.91,0,23600,True,CHARGES,39
25-04-2018,25-Apr-18,To NEFT/SCBL-NOVATECHPROJEC-004418115065344[ID:65344],0,10000000,-74835879.91,-74835879.91,0,10000000,True,NEFT,39
25-04-2018,25-Apr-18,To Comm.onNEFT:/SCBL-NOVATECHPROJEC-004418115065344[ID:65,0,29,-74835908.91,-74835908.91,0,29,True,NEFT,39
25-04-2018,25-Apr-18,To NEFT/SBIN-TANUJAJALAN-004418115065346[ID:65346],0,765000,-75600908.91,-75600908.91,0,765000,True,NEFT,39
25-04-2018,25-Apr-18,To Comm.onNEFT:/SBIN-TANUJAJALAN-004418115065346[ID:6534,0,29,-75600937.91,-75600937.91,0,29,True,NEFT,39
25-04-2018,25-Apr-18,To NEFT/HDFC-TATA CAPITALFI-004418115065345[ID:65345]To Comm.on NEFT:/HDFC-TATA,0,6800000,-82400937.91,-82400937.91,0,6800000,True,NEFT,39
25-04-2018,25-Apr-18,To Comm.on NEFT:/HDFC-TATACAPITALFI-004418115065345[ID:65345],0,29,-82400966.91,-82400966.91,0,29,True,NEFT,39
26-04-2018,26-Apr-18,To SI TL/B-LOAN/180,0,14500,-82415466.91,-82415466.91,0,14500,True,ECS,39
26-04-2018,26-Apr-18,NIMBUS LOGISTICS,0,253500,-82668966.91,-82668966.91,0,253500,True,Others,39
26-04-2018,26-Apr-18,SHAMSHER BAHADURMOURYASRI BALAJI LOGISTIC,0,4800,-82673766.91,-82673766.91,0,4800,True,Others,39
26-04-2018,26-Apr-18,SRI BALAJI LOGISTIC,0,258600,-82932366.91,-82932366.91,0,258600,True,Others,39
26-04-2018,26-Apr-18,ECONOMIC RESEARCH INDIAPVT LTDSUPREME HVAC,0,32400,-82964766.91,-82964766.91,0,32400,True,Others,39
26-04-2018,26-Apr-18,SUPREME HVAC,0,100000,-83064766.91,-83064766.91,0,100000,True,Others,39
26-04-2018,26-Apr-18,To Commission Charged onLC/No.228To Service Charges Charged on,0,5948,-83070714.91,-83070714.91,0,5948,True,CHARGES,39
26-04-2018,26-Apr-18,To Service Charges Charged onLC/No.228To NEFT/BKDN-SUBHOJEET,0,1180,-83071894.91,-83071894.91,0,1180,True,CHARGES,39
27-04-2018,27-Apr-18,To NEFT/BKDN-SUBHOJEETMUKHE-004418117065463[ID:65463],0,12643,-83084537.91,-83084537.91,0,12643,True,NEFT,39
27-04-2018,27-Apr-18,To Comm.onNEFT:/BKDN-SUBHOJEETMUKHE-004418117065463[ID:654,0,6,-83084543.91,-83084543.91,0,6,True,NEFT,39
27-04-2018,27-Apr-18,To Self,0,15000,-83099543.91,-83099543.91,0,15000,True,CASH,39
27-04-2018,27-Apr-18,SHREE KRISHNAENTERPRISESLLOYD S REGISTER ASIA,0,3510,-83103053.91,-83103053.91,0,3510,True,Others,39
27-04-2018,27-Apr-18,LLOYD S REGISTER ASIA,0,151200,-83254253.91,-83254253.91,0,151200,True,Others,39
27-04-2018,27-Apr-18,To NEFT/SCBL-NOVATECHPROJEC-004418117065521[ID:65521],0,500000,-83754253.91,-83754253.91,0,500000,True,NEFT,39
27-04-2018,27-Apr-18,To Comm.onNEFT:/SCBL-NOVATECHPROJEC-004418117065521[ID:65,0,29,-83754282.91,-83754282.91,0,29,True,NEFT,39
27-04-2018,27-Apr-18,By NEFT/HDFC-GARDENREACH SH-N117180528234581[ID:65520],4020189.23,0,-79734093.68,-79734093.68,4020189.22999999,0,True,NEFT,39
27-04-2018,27-Apr-18,To NEFT/BARB-SPINE TECHNOSE-004418117065523[ID:65523]To Comm.on,0,6372,-79740465.68,-79740465.68,0,6372,True,NEFT,39
27-04-2018,27-Apr-18,To Comm.onNEFT:/BARB-SPINE TECHNOSE-004418117065523[ID:65523],0,3,-79740468.68,-79740468.68,0,3,True,NEFT,39
27-04-2018,27-Apr-18,To NEFT/HDFC-ABENGG-004418117065527[ID:65527],0,49500,-79789968.68,-79789968.68,0,49500,True,NEFT,39
27-04-2018,27-Apr-18,27-Apr-2018 To Comm.on NEFT:/HDFC-ABENGG-004418117065527[ID:65527],0,6,-79789974.68,-79789974.68,0,6,True,NEFT,39
30-04-2018,30-Apr-18,30-Apr-2018 To Int. Dr. 01/04/2018-0.0037165510406342901-May-2018 To ACH DR KMBLDRAOPE,0,797309,-80587283.68,-80587283.68,0,797309,True,NACH,39
01-05-2018,1-May-18,01-May-2018 To ACH DR KMBLDRAOPE,0,146889,-80734172.68,-80734172.68,0,146889,True,NACH,39
01-05-2018,1-May-18,01-May-2018 TIME SQUARE LOGISTICS,0,445300,-81179472.68,-81179472.68,0,445300,True,Others,39
02-05-2018,2-May-18,02-May-2018 By RTGS ID:8953 [From199402000015194 ROHANENTERPRISES SHREE,500000,0,-80679472.68,-80679472.68,500000,0,True,RTGS,39
02-05-2018,2-May-18,02-May-2018 By Cash,70800,0,-80608672.68,-80608672.68,70800,0,True,CASH,39
02-05-2018,2-May-18,02-May-2018 To NEFT/UTIB-VAIBHAVSHELKE-004418122065711[ID:65711],0,120547,-80729219.68,-80729219.68,0,120547,True,NEFT,39
02-05-2018,2-May-18,02-May-2018 To Comm.onNEFT:/UTIB-VAIBHAVSHELKE-004418122065711[ID:65,0,16,-80729235.68,-80729235.68,0,16,True,NEFT,39
02-05-2018,2-May-18,02-May-2018 To NEFT/IDIB-CEECONSINDIA-004418122065709[ID:65709],0,50000,-80779235.68,-80779235.68,0,50000,True,NEFT,39
02-05-2018,2-May-18,02-May-2018 To Comm.onNEFT:/IDIB-CEECONSINDIA-004418122065709[ID:6570,0,6,-80779241.68,-80779241.68,0,6,True,NEFT,39
02-05-2018,2-May-18,02-May-2018 To RTGS[ID:8955 For10180000867570 KESHAVTRADING CO],0,561900,-81341141.68,-81341141.68,0,561900,True,RTGS,39
02-05-2018,2-May-18,02-May-2018 To Comm. on RTGS[ID:8955 For10180000867570 KESHAVTRADING CO],0,64,-81341205.68,-81341205.68,0,64,True,RTGS,39
02-05-2018,2-May-18,02-May-2018 To NEFT/BKID-SANTIMOYPAL-004418122065718[ID:65718]02-May-2018 To Comm.on,0,90000,-81431205.68,-81431205.68,0,90000,True,NEFT,39
02-05-2018,2-May-18,02-May-2018 To Comm.onNEFT:/BKID-SANTIMOYPAL-004418122065718[ID:65718],0,6,-81431211.68,-81431211.68,0,6,True,NEFT,39
02-05-2018,2-May-18,02-May-2018 To NEFT/SCBL-SOFTWARE ATWOR-004418122065721[ID:65721],0,12744,-81443955.68,-81443955.68,0,12744,True,NEFT,39
02-05-2018,2-May-18,02-May-2018 To Comm.onNEFT:/SCBL-SOFTWARE ATWOR-004418122065721[ID:65721,0,6,-81443961.68,-81443961.68,0,6,True,NEFT,39
02-05-2018,2-May-18,02-May-2018 To NEFT/ICIC-PALLAB KUMARSI-004418122065725[ID:65725]02-May-2018 To Comm.on NEFT:/ICIC-PALLAB,0,167049,-81611010.68,-81611010.68,0,167049,True,NEFT,39
02-05-2018,2-May-18,02-May-2018 To Comm.on NEFT:/ICIC-PALLABKUMARSI-004418122065725[ID:65725],0,16,-81611026.68,-81611026.68,0,16,True,NEFT,39
03-05-2018,3-May-18,03-May-2018 To ACH DR TP ACH TAT,0,244816,-81855842.68,-81855842.68,0,244816,True,NACH,39
03-05-2018,3-May-18,03-May-2018 To NEFT/BARB-GENERALMECHANI-004418123065816[ID:65816],0,16200,-81872042.68,-81872042.68,0,16200,True,NEFT,39
03-05-2018,3-May-18,03-May-2018 To Comm.onNEFT:/BARB-GENERALMECHANI-004418123065816[ID:6,0,6,-81872048.68,-81872048.68,0,6,True,NEFT,39
03-05-2018,3-May-18,03-May-2018 To NEFT/UTIB-ROHITBHOIR-004418123065817[ID:65817],0,51885,-81923933.68,-81923933.68,0,51885,True,NEFT,39
03-05-2018,3-May-18,03-May-2018 To Comm.on NEFT:/UTIB-ROHITBHOIR-004418123065817[ID:65817],0,6,-81923939.68,-81923939.68,0,6,True,NEFT,39
03-05-2018,3-May-18,03-May-2018 To NEFT/UTIB-AKSHAYMEHRA-004418123065813[ID:65813],0,4538,-81928477.68,-81928477.68,0,4538,True,NEFT,39
03-05-2018,3-May-18,03-May-2018 To Comm.onNEFT:/UTIB-AKSHAYMEHRA-004418123065813[ID:65,0,3,-81928480.68,-81928480.68,0,3,True,NEFT,39
03-05-2018,3-May-18,03-May-2018 To NEFT/UTIB-AMOLLAD-004418123065815[ID:65815]03-May-2018 To Comm.on NEFT:/UTIB-AMOL,0,28254,-81956734.68,-81956734.68,0,28254,True,NEFT,39
03-05-2018,3-May-18,03-May-2018 To Comm.on NEFT:/UTIB-AMOLLAD-004418123065815[ID:65815]03-May-2018 SHREE VISHWAKARMA,0,6,-81956740.68,-81956740.68,0,6,True,NEFT,39
03-05-2018,3-May-18,03-May-2018 SHREE VISHWAKARMAENTERPRISES03-May-2018 MTNL MUMBAI,0,32423,-81989163.68,-81989163.68,0,32423,True,Others,39
03-05-2018,3-May-18,03-May-2018 MTNL MUMBAI,0,2419,-81991582.68,-81991582.68,0,2419,True,Others,39
03-05-2018,3-May-18,03-May-2018 VISHWAKARMA UDYOG,0,111460,-82103042.68,-82103042.68,0,111460,True,Others,39
03-05-2018,3-May-18,03-May-2018 AMIT FASTENERS,0,132243,-82235285.68,-82235285.68,0,132243,True,Others,39
03-05-2018,3-May-18,03-May-2018 JOHN GALT INTERNATIONAL,0,955800,-83191085.68,-83191085.68,0,955800,True,Others,39
03-05-2018,3-May-18,03-May-2018 SAMBHAV ENTERPRISES,0,183630,-83374715.68,-83374715.68,0,183630,True,Others,39
03-05-2018,3-May-18,03-May-2018 DEV QUALITY CONSULTANTAAND ASSOCIATION03-May-2018 PRECIOUS MACHINE TOOLS,0,32500,-83407215.68,-83407215.68,0,32500,True,Others,39
03-05-2018,3-May-18,03-May-2018 PRECIOUS MACHINE TOOLS,0,224160,-83631375.68,-83631375.68,0,224160,True,Others,39
04-05-2018,4-May-18,04-May-2018 ABDUL FABRICATOR,0,50000,-83681375.68,-83681375.68,0,50000,True,Others,39
04-05-2018,4-May-18,04-May-2018 NIKHIL PRODUCTS CO,0,141954,-83823329.68,-83823329.68,0,141954,True,Others,39
04-05-2018,4-May-18,04-May-2018 MTNL MUMBAI,0,1091,-83824420.68,-83824420.68,0,1091,True,Others,39
04-05-2018,4-May-18,04-May-2018 V K TRANSPORT SERVICE,0,200000,-84024420.68,-84024420.68,0,200000,True,Others,39
04-05-2018,4-May-18,04-May-2018 AO CASH BSNL KALYAN,0,3352,-84027772.68,-84027772.68,0,3352,True,CASH,39
04-05-2018,4-May-18,04-May-2018 UNIQUE ENGINEERS,0,223502,-84251274.68,-84251274.68,0,223502,True,Others,39
04-05-2018,4-May-18,04-May-2018 AO CASH BSNL KALYAN,0,1476,-84252750.68,-84252750.68,0,1476,True,CASH,39
04-05-2018,4-May-18,04-May-2018 MTNL MUMBAI,0,2183,-84254933.68,-84254933.68,0,2183,True,Others,39
04-05-2018,4-May-18,04-May-2018 JOHN GALT INTERNATIONAL,0,119600,-84374533.68,-84374533.68,0,119600,True,Others,39
04-05-2018,4-May-18,04-May-2018 BUDHAJI MAYA PATIL,0,1800,-84376333.68,-84376333.68,0,1800,True,Others,39
04-05-2018,4-May-18,04-May-2018 ASHOKA BEARINGENTERPRISE04-May-2018 KANASE NAVNATH,0,132183,-84508516.68,-84508516.68,0,132183,True,Others,39
04-05-2018,4-May-18,04-May-2018 KANASE NAVNATHDate Particulars04-May-2018 By NEFT ID:65960 [From,0,35344,-84543860.68,-84543860.68,0,35344,True,NEFT,39
04-05-2018,4-May-18,04-May-2018 By NEFT ID:65960 [FromRAMAGUNDAM FERTILIZERSAND],977290,0,-83566570.68,-83566570.68,977290,0,True,NEFT,39
04-05-2018,4-May-18,04-May-2018 By NEFT ID:65961 [FromRAMAGUNDAM FERTILIZERSAND],1679904,0,-81886666.68,-81886666.68,1679904,0,True,NEFT,39
04-05-2018,4-May-18,04-May-2018 To NEFT/SCBL-DAYANANDSONAWA-004418124065963[ID:65963],0,15000,-81901666.68,-81901666.68,0,15000,True,NEFT,39
04-05-2018,4-May-18,04-May-2018 To Comm.onNEFT:/SCBL-DAYANANDSONAWA-004418124065963[ID:6,0,6,-81901672.68,-81901672.68,0,6,True,NEFT,39
05-05-2018,5-May-18,05-May-2018 To ACH DR BDACH-RTBN,0,98440,-82000112.68,-82000112.68,0,98440,True,NACH,39
05-05-2018,5-May-18,"05-May-2018 To REALISATION OF BHEL/116,11705-May-2018 To ACH DR ADITY BIRL",0,1498398,-83498510.68,-83498510.68,0,1498398,True,NACH,39
05-05-2018,5-May-18,05-May-2018 To ACH DR ADITY BIRL,0,203544,-83702054.68,-83702054.68,0,203544,True,NACH,39
05-05-2018,5-May-18,05-May-2018 To ACH DR IVL FINANC,0,179511,-83881565.68,-83881565.68,0,179511,True,NACH,39
05-05-2018,5-May-18,05-May-2018 MANIBHADRA TUBECORPORATION05-May-2018 SHREE SHYAM LOGISTICS,0,97949,-83979514.68,-83979514.68,0,97949,True,Others,39
05-05-2018,5-May-18,05-May-2018 SHREE SHYAM LOGISTICS,0,84100,-84063614.68,-84063614.68,0,84100,True,Others,39
05-05-2018,5-May-18,05-May-2018 OM SHIV JAGRUTI CANTEEN,0,17454,-84081068.68,-84081068.68,0,17454,True,Others,39
05-05-2018,5-May-18,05-May-2018 PROGRESSIVE ENGINEERING,0,32400,-84113468.68,-84113468.68,0,32400,True,Others,39
05-05-2018,5-May-18,05-May-2018 HINDUSTAN BOLT NUT CO,0,114785,-84228253.68,-84228253.68,0,114785,True,Others,39
05-05-2018,5-May-18,05-May-2018 R S ENGINEERING,0,19760,-84248013.68,-84248013.68,0,19760,True,Others,39
05-05-2018,5-May-18,05-May-2018 SHREE LAKSHMI DISH ENDAND ENGG WORKS05-May-2018 To NEFT/TMBL-MAHARA,0,35178,-84283191.68,-84283191.68,0,35178,True,NEFT,39
05-05-2018,5-May-18,05-May-2018 To NEFT/TMBL-MAHARACONSTRUC-004418125066035[ID:66035],0,98000,-84381191.68,-84381191.68,0,98000,True,NEFT,39
05-05-2018,5-May-18,05-May-2018 To Comm.onNEFT:/TMBL-MAHARACONSTRUC-004418125066035[ID,0,6,-84381197.68,-84381197.68,0,6,True,NEFT,39
05-05-2018,5-May-18,05-May-2018 To NEFT/KKBK-SOUMADEEPSUKUM-004418125066034[ID:66034],0,29592,-84410789.68,-84410789.68,0,29592,True,NEFT,39
05-05-2018,5-May-18,05-May-2018 To Comm.onNEFT:/KKBK-SOUMADEEPSUKUM-004418125066034[ID:66,0,6,-84410795.68,-84410795.68,0,6,True,NEFT,39
05-05-2018,5-May-18,05-May-2018 By MrgRev.GEN(BD)7/1182/HundiNo.BHEL/116,51258.3,0,-84359537.38,-84359537.38,51258.3000000119,0,True,Others,39
05-05-2018,5-May-18,05-May-2018 To Hundi No (BHEL/116),0,2477,-84362014.38,-84362014.38,0,2477,True,Others,39
05-05-2018,5-May-18,05-May-2018 By MrgRev.GEN(BD)7/1183/HundiNo.BHEL/117,98581.5,0,-84263432.88,-84263432.88,98581.5,0,True,Others,39
05-05-2018,5-May-18,05-May-2018 To Hundi No (BHEL/117)Date Particulars07-May-2018 To ACH DR MAGMAFINCO,0,4764,-84268196.88,-84268196.88,0,4764,True,NACH,39
07-05-2018,7-May-18,07-May-2018 To ACH DR MAGMAFINCO,0,121329,-84389525.88,-84389525.88,0,121329,True,NACH,39
07-05-2018,7-May-18,07-May-2018 To ACH DR MAGMAFINCO,0,161578,-84551103.88,-84551103.88,0,161578,True,NACH,39
07-05-2018,7-May-18,07-May-2018 J S P MACHINERY,0,17703,-84568806.88,-84568806.88,0,17703,True,Others,39
07-05-2018,7-May-18,07-May-2018 By Disc. GEN(BD)7/HundiNo.BHEL/16107-May-2018 To Disc. GEN(BD)7/Hundi,1354959.21,0,-83213847.67,-83213847.67,1354959.20999999,0,True,Others,39
07-05-2018,7-May-18,07-May-2018 To Disc. GEN(BD)7/HundiNo.BHEL/16107-May-2018 To RTGS[ID:8981 For 0112396848,0,30626,-83244473.67,-83244473.67,0,30626,True,RTGS,39
07-05-2018,7-May-18,07-May-2018 To RTGS[ID:8981 For 0112396848INESH ACCERRO LTD]07-May-2018 To Comm. on RTGS[ID:8981 For,0,902226,-84146699.67,-84146699.67,0,902226,True,RTGS,39
07-05-2018,7-May-18,07-May-2018 To Comm. on RTGS[ID:8981 For0112396848 INESH ACCERROLTD],0,64,-84146763.67,-84146763.67,0,64,True,RTGS,39
07-05-2018,7-May-18,07-May-2018 To ACH DR CLIXCAPITA,0,123606,-84270369.67,-84270369.67,0,123606,True,NACH,39
07-05-2018,7-May-18,07-May-2018 To RTGS[ID:8985 For24605053424 NOVATECHPROJECTS I PVT LTD],0,600000,-84870369.67,-84870369.67,0,600000,True,RTGS,39
07-05-2018,7-May-18,07-May-2018 To Comm. on RTGS[ID:8985 For24605053424 NOVATECHPROJECTS I PVT LTD],0,64,-84870433.67,-84870433.67,0,64,True,RTGS,39
08-05-2018,8-May-18,08-May-2018 To DECS HDFC BANK4623922308-May-2018 To Service Charges Charged on,0,11900,-84882333.67,-84882333.67,0,11900,True,CHARGES,39
08-05-2018,8-May-18,08-May-2018 To Service Charges Charged onLC/No.22908-May-2018 To Self,0,1180,-84883513.67,-84883513.67,0,1180,True,CHARGES,39
08-05-2018,8-May-18,08-May-2018 To Self,0,25000,-84908513.67,-84908513.67,0,25000,True,CASH,39
09-05-2018,9-May-18,09-May-2018 By RTGS ID:8998 [From120313023790 NOVATECHPROJECTS (INDIA) PVT LTD 601,1000000,0,-83908513.67,-83908513.67,1000000,0,True,RTGS,39
09-05-2018,9-May-18,09-May-2018 To LC-No 192 Retired,0,1002056,-84910569.67,-84910569.67,0,1002056,True,Others,39
09-05-2018,9-May-18,09-May-2018 SHRI MAYURESH AUTOMOBILE,0,24000,-84934569.67,-84934569.67,0,24000,True,Others,39
09-05-2018,9-May-18,09-May-2018 ATUL D PAWAR,0,4500,-84939069.67,-84939069.67,0,4500,True,Others,39
09-05-2018,9-May-18,09-May-2018 To PART COMMSSION ON LCNO 22709-May-2018 To PART COMMSSION ON LC,0,312,-84939381.67,-84939381.67,0,312,True,Others,39
09-05-2018,9-May-18,09-May-2018 To PART COMMSSION ON LCNO 22810-May-2018 By NEFT/SCBL-MS NOVATECH,0,125,-84939506.67,-84939506.67,0,125,True,NEFT,39
10-05-2018,10-May-18,10-May-2018 By NEFT/SCBL-MS NOVATECHPRO-SIN20995Q0002077[ID:66322],3500000,0,-81439506.67,-81439506.67,3500000,0,True,NEFT,39
10-05-2018,10-May-18,10-May-2018 By RTGS ID:9002 [From199402000015194 ROHANENTERPRISES SHREE,500000,0,-80939506.67,-80939506.67,500000,0,True,RTGS,39
10-05-2018,10-May-18,10-May-2018 To NEFT/UTIB-DIPAKGHOSH-004418130066371[ID:66371],0,100000,-81039506.67,-81039506.67,0,100000,True,NEFT,39
10-05-2018,10-May-18,10-May-2018 To Comm.on NEFT:/UTIB-DIPAKGHOSH-004418130066371[ID:66371],0,6,-81039512.67,-81039512.67,0,6,True,NEFT,39
10-05-2018,10-May-18,10-May-2018 ABHISHEK CARGO MOVERS,0,16250,-81055762.67,-81055762.67,0,16250,True,Others,39
10-05-2018,10-May-18,10-May-2018 CHAMUNDA BEARING,0,12722,-81068484.67,-81068484.67,0,12722,True,Others,39
10-05-2018,10-May-18,10-May-2018 SD XEROX,0,3795,-81072279.67,-81072279.67,0,3795,True,Others,39
10-05-2018,10-May-18,10-May-2018 To RTGS[ID:9010 For10180000867570 KESHAVTRADING CO],0,561900,-81634179.67,-81634179.67,0,561900,True,RTGS,39
10-05-2018,10-May-18,10-May-2018 To Comm. on RTGS[ID:9010 For10180000867570 KESHAVTRADING CO],0,64,-81634243.67,-81634243.67,0,64,True,RTGS,39
11-05-2018,11-May-18,11-May-2018 To SI TL/B-LOAN/149,0,101876,-81736119.67,-81736119.67,0,101876,True,ECS,39
11-05-2018,11-May-18,11-May-2018 To LC-No 172 Retired,0,169663,-81905782.67,-81905782.67,0,169663,True,Others,39
11-05-2018,11-May-18,11-May-2018 To LC-No 191 Retired,0,829383,-82735165.67,-82735165.67,0,829383,True,Others,39
11-05-2018,11-May-18,11-May-2018 KWALITY AUTO PAINTS,0,250000,-82985165.67,-82985165.67,0,250000,True,Others,39
11-05-2018,11-May-18,11-May-2018 DIAMOND GLASS WORKS,0,29700,-83014865.67,-83014865.67,0,29700,True,Others,39
11-05-2018,11-May-18,11-May-2018 J M TRADERS,0,223050,-83237915.67,-83237915.67,0,223050,True,Others,39
14-05-2018,14-May-18,14-May-2018 By NEFT ID:66538 [From RAMMULTITRADERS PVT LTD]14-May-2018 SPENTA GASKETS AND SEALS,1,0,-83237914.67,-83237914.67,1,0,True,NEFT,39
14-05-2018,14-May-18,14-May-2018 SPENTA GASKETS AND SEALS,0,94400,-83332314.67,-83332314.67,0,94400,True,Others,39
14-05-2018,14-May-18,14-May-2018 LAD A M,0,50000,-83382314.67,-83382314.67,0,50000,True,Others,39
14-05-2018,14-May-18,14-May-2018 GANGARAM DINKAR PATIL,0,7008,-83389322.67,-83389322.67,0,7008,True,Others,39
14-05-2018,14-May-18,14-May-2018 AP CLEANING WORKS,0,335635,-83724957.67,-83724957.67,0,335635,True,Others,39
14-05-2018,14-May-18,14-May-2018 KALYAN COMMERCIALAGENCIES14-May-2018 By RTGS ID:9030 [From,0,1077957,-84802914.67,-84802914.67,0,1077957,True,RTGS,39
14-05-2018,14-May-18,14-May-2018 By RTGS ID:9030 [From36331670348 BGR ENERGYSYSTEMS LIMITED SBI CAG,1016603,0,-83786311.67,-83786311.67,1016603,0,True,RTGS,39
14-05-2018,14-May-18,14-May-2018 By NEFT ID:66602 [FromNOVATECH PROJECTS (INDIA)PVT LTD],2100000,0,-81686311.67,-81686311.67,2100000,0,True,NEFT,39
14-05-2018,14-May-18,14-May-2018 To LC-No 174 Retired,0,1600000,-83286311.67,-83286311.67,0,1600000,True,Others,39
14-05-2018,14-May-18,14-May-2018 To LC PAYMENT LC NO 174,0,518173,-83804484.67,-83804484.67,0,518173,True,Others,39
15-05-2018,15-May-18,15-May-2018 To SI TL/B-LOAN/187,0,35700,-83840184.67,-83840184.67,0,35700,True,ECS,39
15-05-2018,15-May-18,15-May-2018 by o/w-240/15-DAI-ICHIKARKARIA LIMITED15-May-2018 By NEFT ID:66639 [From RAM,525000,0,-83315184.67,-83315184.67,525000,0,True,OUTWARD,39
15-05-2018,15-May-18,15-May-2018 By NEFT ID:66639 [From RAMMULTITRADERS PVT LTD]15-May-2018 To DECS TP-ICICI B,1,0,-83315183.67,-83315183.67,1,0,True,NEFT,39
15-05-2018,15-May-18,15-May-2018 To DECS TP-ICICI B145540048215-May-2018 To NEFT/IBKL-SVC CO,0,13680,-83328863.67,-83328863.67,0,13680,True,NEFT,39
15-05-2018,15-May-18,15-May-2018 To NEFT/IBKL-SVC COOPERATIV-004418135066647[ID:66647],0,11775,-83340638.67,-83340638.67,0,11775,True,NEFT,39
15-05-2018,15-May-18,15-May-2018 To Comm.on NEFT:/IBKL-SVCCOOPERATIV-004418135066647[ID:,0,6,-83340644.67,-83340644.67,0,6,True,NEFT,39
15-05-2018,15-May-18,15-May-2018 MALI TUKARAM DNYANU,0,4500,-83345144.67,-83345144.67,0,4500,True,Others,39
15-05-2018,15-May-18,15-May-2018 MALLIK ENGINEERING WORKS,0,22301,-83367445.67,-83367445.67,0,22301,True,Others,39
15-05-2018,15-May-18,15-May-2018 HOTEL UDYOG VIHAR,0,5495,-83372940.67,-83372940.67,0,5495,True,Others,39
15-05-2018,15-May-18,15-May-2018 FAMOUS ELECTRIC WORKS,0,6254,-83379194.67,-83379194.67,0,6254,True,Others,39
15-05-2018,15-May-18,15-May-2018 To COMMISSION ON LC ISSUEDBY AXIS LC NO 93716-May-2018 by o/w-37/2-INSECTICIDES INDIA,0,8850,-83388044.67,-83388044.67,0,8850,True,CHARGES,39
16-05-2018,16-May-18,16-May-2018 by o/w-37/2-INSECTICIDES INDIALIMITED16-May-2018 by o/w-229/2-BERGER PAINTS,2000000,0,-81388044.67,-81388044.67,2000000,0,True,OUTWARD,39
16-05-2018,16-May-18,16-May-2018 by o/w-229/2-BERGER PAINTSINDIA LIMITED16-May-2018 SHIVOM ENTERPRISES,4278000,0,-77110044.67,-77110044.67,4278000,0,True,OUTWARD,39
16-05-2018,16-May-18,16-May-2018 SHIVOM ENTERPRISES,0,24072,-77134116.67,-77134116.67,0,24072,True,Others,39
16-05-2018,16-May-18,16-May-2018 BONFIGLIOLI TRANSMISSIONSPVT LTD17-May-2018 To Self,0,76608,-77210724.67,-77210724.67,0,76608,True,CASH,39
17-05-2018,17-May-18,17-May-2018 To Self,0,20000,-77230724.67,-77230724.67,0,20000,True,CASH,39
17-05-2018,17-May-18,17-May-2018 To Commission Charged onLC/No.23117-May-2018 To Service Charges Charged on,0,17700,-77248424.67,-77248424.67,0,17700,True,CHARGES,39
17-05-2018,17-May-18,17-May-2018 To Service Charges Charged onLC/No.23117-May-2018 FAITHFUL GOODS CARRIER,0,1180,-77249604.67,-77249604.67,0,1180,True,CHARGES,39
17-05-2018,17-May-18,17-May-2018 FAITHFUL GOODS CARRIER,0,251100,-77500704.67,-77500704.67,0,251100,True,Others,39
17-05-2018,17-May-18,"17-May-2018 To REALISATION OF BILLSBER/TAL/025, AMB/5817-May-2018 By Mrg",0,5667012,-83167716.67,-83167716.67,0,5667012,True,Others,39
17-05-2018,17-May-18,17-May-2018 By MrgRev.GEN(BD)7/1187/HundiNo.BERGER/TAL/025,168768.4,0,-82998948.27,-82998948.27,168768.400000006,0,True,Others,39
17-05-2018,17-May-18,17-May-2018 To Hundi No (BERGER/TAL/025),0,7574,-83006522.27,-83006522.27,0,7574,True,Others,39
17-05-2018,17-May-18,17-May-2018 By MrgRev.GEN(BD)7/1198/HundiNo.AMB/58/17-18,397932.8,0,-82608589.47,-82608589.47,397932.799999997,0,True,Others,39
17-05-2018,17-May-18,17-May-2018 To Hundi No (AMB/58/17-18),0,17858,-82626447.47,-82626447.47,0,17858,True,Others,39
17-05-2018,17-May-18,17-May-2018 By Disc. GEN(BD)7/HundiNo.AMB/000917-May-2018 To Disc. GEN(BD)7/Hundi,4832949.6,0,-77793497.87,-77793497.87,4832949.59999999,0,True,Others,39
17-05-2018,17-May-18,17-May-2018 To Disc. GEN(BD)7/HundiNo.AMB/000917-May-2018 To Commission Charged on,0,99042,-77892539.87,-77892539.87,0,99042,True,CHARGES,39
17-05-2018,17-May-18,17-May-2018 To Commission Charged onLC/No.23217-May-2018 To Service Charges Charged on,0,19139,-77911678.87,-77911678.87,0,19139,True,CHARGES,39
17-05-2018,17-May-18,17-May-2018 To Service Charges Charged onLC/No.23218-May-2018 ELCA LABORATORIES,0,1180,-77912858.87,-77912858.87,0,1180,True,CHARGES,39
18-05-2018,18-May-18,18-May-2018 ELCA LABORATORIES,0,40163,-77953021.87,-77953021.87,0,40163,True,Others,39
18-05-2018,18-May-18,18-May-2018 PICK MY URL,0,20000,-77973021.87,-77973021.87,0,20000,True,Others,39
18-05-2018,18-May-18,18-May-2018 KAMAL AGENCIES,0,187310,-78160331.87,-78160331.87,0,187310,True,Others,39
18-05-2018,18-May-18,18-May-2018 By NEFT ID:66899 [FromRAMAGUNDAM FERTILIZERSAND],1036112,0,-77124219.87,-77124219.87,1036112,0,True,NEFT,39
18-05-2018,18-May-18,18-May-2018 By RTGS ID:9061 From36331670348BGR ENERGYSYSTEMS LIMITEDSBI CAG,4379456,0,-72744763.87,-72744763.87,4379456,0,True,RTGS,39
18-05-2018,18-May-18,18-May-2018 To REALISATION OF BILLAMB/06118-May-2018 To PART AMT OF REALISATION,0,370555.5,-73115319.37,-73115319.37,0,370555.5,True,Others,39
18-05-2018,18-May-18,18-May-2018 To PART AMT OF REALISATIONOF AMB/06118-May-2018 By Mrg,0,3334999.5,-76450318.87,-76450318.87,0,3334999.5,True,Others,39
18-05-2018,18-May-18,18-May-2018 By MrgRev.GEN(BD)7/1199/HundiNo.AMB/61/17-18,370555.5,0,-76079763.37,-76079763.37,370555.5,0,True,Others,39
18-05-2018,18-May-18,18-May-2018 To Hundi No (AMB/61/17-18),0,8954,-76088717.37,-76088717.37,0,8954,True,Others,39
18-05-2018,18-May-18,18-May-2018 By Disc. GEN(BD)7/HundiNo.TAL/000218-May-2018 To Disc. GEN(BD)7/Hundi,3026700,0,-73062017.37,-73062017.37,3026700,0,True,Others,39
18-05-2018,18-May-18,18-May-2018 To Disc. GEN(BD)7/HundiNo.TAL/000219-May-2018 To LC-No 187 Retired,0,63851,-73125868.37,-73125868.37,0,63851,True,Others,39
19-05-2018,19-May-18,19-May-2018 To LC-No 187 Retired,0,10984851,-84110719.37,-84110719.37,0,10984851,True,Others,39
19-05-2018,19-May-18,19-May-2018 By RTGS ID:9066 From24605053424M/S NOVATECHPROJECTS (I) PRIVATE,3000000,0,-81110719.37,-81110719.37,3000000,0,True,RTGS,39
19-05-2018,19-May-18,19-May-2018 To RTGS[ID:9069 For32343227367 NOVATECHPROJECTS I PVT LTD],0,1300000,-82410719.37,-82410719.37,0,1300000,True,RTGS,39
19-05-2018,19-May-18,19-May-2018 To Comm. on RTGS[ID:9069 For32343227367 NOVATECHPROJECTS I PVT LTD],0,60,-82410779.37,-82410779.37,0,60,True,RTGS,39
19-05-2018,19-May-18,19-May-2018 PILOT GASKETSANDENGINEERS19-May-2018 To PAY ORDER,0,992220,-83402999.37,-83402999.37,0,992220,True,Others,39
19-05-2018,19-May-18,19-May-2018 To PAY ORDER,0,388783,-83791782.37,-83791782.37,0,388783,True,Others,39
19-05-2018,19-May-18,19-May-2018 To PAY ORDER-COMMISSION,0,1440,-83793222.37,-83793222.37,0,1440,True,CHARGES,39
21-05-2018,21-May-18,21-May-2018 By RTGS ID:9082 [From140310000725BERGERAUTOANDINDUSTRIAL,2176059,0,-81617163.37,-81617163.37,2176059,0,True,RTGS,39
21-05-2018,21-May-18,21-May-2018 To NEFT/BARB-SUMANA AVIJITG-004418141067043[ID:67043]21-May-2018 To Comm.on,0,12098,-81629261.37,-81629261.37,0,12098,True,NEFT,39
21-05-2018,21-May-18,21-May-2018 To Comm.onNEFT:/BARB-SUMANA AVIJITG-004418141067043[ID:67043],0,6,-81629267.37,-81629267.37,0,6,True,NEFT,39
21-05-2018,21-May-18,21-May-2018 By RTGS ID:9089 [From36331670348 BGR ENERGYSYSTEMS LIMITED SBI CAG,776352,0,-80852915.37,-80852915.37,776352,0,True,RTGS,39
21-05-2018,21-May-18,21-May-2018 By Disc. GEN(BD)7/HundiNo.TAL/000421-May-2018 To Disc. GEN(BD)7/Hundi,969379.2,0,-79883536.17,-79883536.17,969379.200000003,0,True,Others,39
21-05-2018,21-May-18,21-May-2018 To Disc. GEN(BD)7/HundiNo.TAL/0004Date Particulars,0,21911,-79905447.17,-79905447.17,0,21911,True,Others,39
21-05-2018,21-May-18,21-May-2018 To NEFT/IBKL-CASCOINTERNATI-004418141067061[ID:67061],0,386959,-80292406.17,-80292406.17,0,386959,True,NEFT,39
21-05-2018,21-May-18,21-May-2018 To Comm.on NEFT:/IBKL-CASCOINTERNATI-004418141067061[ID:67061],0,29,-80292435.17,-80292435.17,0,29,True,NEFT,39
22-05-2018,22-May-18,22-May-2018 To RTGS[ID:9092 For913010045050789 VAIBHAVSHELKE],0,259819,-80552254.17,-80552254.17,0,259819,True,RTGS,39
22-05-2018,22-May-18,22-May-2018 To Comm. on RTGS[ID:9092 For913010045050789 VAIBHAVSHELKE],0,32,-80552286.17,-80552286.17,0,32,True,RTGS,39
22-05-2018,22-May-18,22-May-2018 To DORV PROCESSEQUIPMENTS PVT LTD22-May-2018 To NEFT/IBKL-PRANKRISHNA,0,80000,-80632286.17,-80632286.17,0,80000,True,NEFT,39
22-05-2018,22-May-18,22-May-2018 To NEFT/IBKL-PRANKRISHNASAN-004418142067106[ID:67106]22-May-2018 To Comm.on,0,25000,-80657286.17,-80657286.17,0,25000,True,NEFT,39
22-05-2018,22-May-18,22-May-2018 To Comm.onNEFT:/IBKL-PRANKRISHNASAN-004418142067106[ID:67106],0,6,-80657292.17,-80657292.17,0,6,True,NEFT,39
22-05-2018,22-May-18,22-May-2018 To NEFT/UTIB-SHAHANWAZALAM-004418142067108[ID:67108],0,20000,-80677292.17,-80677292.17,0,20000,True,NEFT,39
22-05-2018,22-May-18,22-May-2018 To Comm.onNEFT:/UTIB-SHAHANWAZALAM-004418142067108[ID:6710,0,6,-80677298.17,-80677298.17,0,6,True,NEFT,39
22-05-2018,22-May-18,22-May-2018 To NEFT/TJSB-N ATRADING-004418142067107[ID:67107],0,9912,-80687210.17,-80687210.17,0,9912,True,NEFT,39
22-05-2018,22-May-18,22-May-2018 To Comm.on NEFT:/TJSB-N ATRADING-004418142067107[ID:67107],0,3,-80687213.17,-80687213.17,0,3,True,NEFT,39
22-05-2018,22-May-18,22-May-2018 SIDDHIVINAYAK ENTERPRISES,0,12000,-80699213.17,-80699213.17,0,12000,True,Others,39
22-05-2018,22-May-18,22-May-2018 To RTGS[ID:9095 For00687610000464 A BENGINEERING],0,255044,-80954257.17,-80954257.17,0,255044,True,RTGS,39
22-05-2018,22-May-18,22-May-2018 To Comm. on RTGS[ID:9095 For00687610000464 A BENGINEERING],0,35,-80954292.17,-80954292.17,0,35,True,RTGS,39
22-05-2018,22-May-18,22-May-2018 To NEFT/IBKL-PRANKRISHNASAN-004418142067126[ID:67126]22-May-2018 To Comm.on,0,160281,-81114573.17,-81114573.17,0,160281,True,NEFT,39
22-05-2018,22-May-18,22-May-2018 To Comm.onNEFT:/IBKL-PRANKRISHNASAN-004418142067126[ID:67126],0,16,-81114589.17,-81114589.17,0,16,True,NEFT,39
23-05-2018,23-May-18,23-May-2018 To Commission Charged onLC/No.23323-May-2018 To Service Charges Charged on,0,53101,-81167690.17,-81167690.17,0,53101,True,CHARGES,39
23-05-2018,23-May-18,23-May-2018 To Service Charges Charged onLC/No.23323-May-2018 J B ENGINEERING,0,1180,-81168870.17,-81168870.17,0,1180,True,CHARGES,39
23-05-2018,23-May-18,23-May-2018 J B ENGINEERINGCORPORATION23-May-2018 MTANDT RENTALS LIMITED,0,163536,-81332406.17,-81332406.17,0,163536,True,Others,39
23-05-2018,23-May-18,23-May-2018 MTANDT RENTALS LIMITED,0,200000,-81532406.17,-81532406.17,0,200000,True,Others,39
23-05-2018,23-May-18,23-May-2018 By NEFT ID:67196 [FromLONSEN KIRI CHEMICALINDUSTRIES LTD],196416,0,-81335990.17,-81335990.17,196416,0,True,NEFT,39
24-05-2018,24-May-18,24-May-2018 By RTGS ID:9107 [From36530729001 RFCL NEW DELHI],2427002,0,-78908988.17,-78908988.17,2427002,0,True,RTGS,39
24-05-2018,24-May-18,24-May-2018 By NEFT/SBIN-BGR ENERGYSYST-SBIN918144274748[ID:67285],4160538.5,0,-74748449.67,-74748449.67,4160538.5,0,True,NEFT,39
25-05-2018,25-May-18,25-May-2018 To LC-No 199 Retired,0,1584074,-76332523.67,-76332523.67,0,1584074,True,Others,39
25-05-2018,25-May-18,25-May-2018 To RTGS[ID:9120 For698005600138 LEGALCATALYST],0,367810,-76700333.67,-76700333.67,0,367810,True,RTGS,39
25-05-2018,25-May-18,25-May-2018 To Comm. on RTGS[ID:9120 For698005600138 LEGALCATALYST],0,35,-76700368.67,-76700368.67,0,35,True,RTGS,39
25-05-2018,25-May-18,25-May-2018 To NEFT/BKID-K S BBRICKS-004418145067318[ID:67318],0,145600,-76845968.67,-76845968.67,0,145600,True,NEFT,39
25-05-2018,25-May-18,25-May-2018 To Comm.on NEFT:/BKID-K S BBRICKS-004418145067318[ID:67318],0,16,-76845984.67,-76845984.67,0,16,True,NEFT,39
